bill 已知	账单法案
everything 已知	一切事物
off 已知	离开断开
rate 已知	比率评估
party 已知	政党聚会
feeling 已知	感觉情感
however 已知	然而可是
side 已知	侧面一方
certain 已知	确定某些
eyes 已知	眼睛视力
position 已知	位置职位
wrong 已知	错误不对
marry 已知	结婚嫁娶
while 已知	同时然而
Oh 已知	翻译出错，请更新
true 已知	真实正确
leave 已知	离开休假
spoken 已知	口头讲的
hour 已知	小时钟头
least 已知	最少最小
Government 已知	翻译出错，请更新
yourself 已知	你自己们
Saulsby 已知	翻译出错，请更新
coming 已知	即将来临
declared 已知	宣布声明
kind 已知	种类和蔼
looked 已知	看过瞧过
night 已知	夜晚晚上
else 已知	其他别的
gone 已知	离去走了
used 已知	用过旧的
idea 已知	主意想法
lord 已知	上帝阁下
name 已知	名字命名
chance 已知	机会机遇
duty 已知	责任义务
face 已知	脸面
loved 已知	热爱喜爱
ought 已知	应该
political 已知	政治的
sat 已知	坐过坐了
saw 已知	看见锯子
talk 已知	说
dinner 已知	晚餐正餐
doing 已知	正在做事
each 已知	每个
Loughton 已知	翻译出错，请更新
brought 已知	带来拿来
few 已知	很少几个
hands 已知	手指针帮
year 已知	年份年度
call 已知	呼叫
hard 已知	坚硬
received 已知	收到接到
altogether 已知	总共完全
either 已知	任何一个
help 已知	帮助
next 已知	下一个的
part 已知	部分角色
session 已知	会议开庭
hear 已知	听见听到
lady 已知	女士夫人
rather 已知	宁可宁愿
success 已知	成功胜利
Minister 已知	翻译出错，请更新
live 已知	居住生活
began 已知	开始启动
gentleman 已知	绅士先生
politics 已知	政治事务
care 已知	照顾关心
end 已知	结束终止
poor 已知	贫穷贫困
simply 已知	简单朴素
able 已知	能够有才
already 已知	已经早已
less 已知	更少较少
looking 已知	看着瞧着
often 已知	常常经常
really 已知	真正
Chapter 已知	翻译出错，请更新
Oswald 已知	翻译出错，请更新
means 已知	方法
strong 已知	强壮强烈
therefore 已知	因此所以
whole 已知	全部整体
Square 已知	翻译出错，请更新
remember 已知	记得记住
pleasant 已知	愉快舒适
sitting 已知	坐着在坐
stand 已知	站立忍受
unless 已知	除非如果
Im 已知	翻译出错，请更新
bad 已知	坏的不好
borough 已知	市镇区域
door 已知	门出入口
evening 已知	晚上傍晚
meet 已知	相遇遇见
where 已知	哪里何处
Palliser 已知	翻译出错，请更新
making 已知	制作制造
Ratler 已知	翻译出错，请更新
during 已知	在…… 期间
head 已知	头头脑部
occasion 已知	场合时机
angry 已知	生气
full 已知	充满满的
speaking 已知	说话讲话
standing 已知	站立地位
Reform 已知	翻译出错，请更新
allowed 已知	翻译出错，请更新
business 已知	商业 2
glad 已知	高兴
late 已知	晚的
members 已知	成员
sort 已知	分类
Ireland 已知	翻译出错，请更新
Loughshane 已知	翻译出错，请更新
early 已知	早期的
fact 已知	事实
Omnium 已知	翻译出错，请更新
Slide 已知	翻译出错，请更新
close 已知	接近
four 已知	四 14
happy 已知	快乐的
women 已知	女性
aware 已知	意识到
nor 已知	也不
round 已知	圆
sit 已知	坐
Cantrip 已知	翻译出错，请更新
Jones 已知	翻译出错，请更新
Killaloe 已知	翻译出错，请更新
aunt 已知	姨妈
intended 已知	预期的
stood 已知	站
try 已知	尝
high 已知	高的
power 已知	力量
walked 已知	走路
Ill 已知	翻译出错，请更新
girl 已知	女孩
married 已知	结婚
necessary 已知	必要的
resolved 已知	决心 35
towards 已知	朝向
voice 已知	声音
yes 已知	是的
Flood 已知	翻译出错，请更新
afraid 已知	害
deal 已知	交易
return 已知	返回
understood 已知	理解
Sunday 已知	翻译出错，请更新
continued 已知	继续
debate 已知	辩论
doctor 已知	医生
duel 已知	决斗
reason 已知	理由
trouble 已知	麻烦
turned 已知	转向
under 已知	在……之下
cant 已知	不会
read 已知	阅读
second 已知	第二
themselves 已知	他们自己
tomorrow 已知	明天
within 已知	在……之内
keep 已知	保持
saying 已知	说
wont 已知	不会
written 已知	写
bound 已知	绑定
fear 已知	害怕
fellow 已知	同伴
impossible 已知	不可能的
special 已知	特别的
Fawn 已知	翻译出错，请更新
Irish 已知	翻译出错，请更新
manner 已知	方式
note 已知	笔记
wanted 已知	想要
write 已知	写
Clarkson 已知	翻译出错，请更新
boy 已知	男孩
need 已知	需要
replied 已知	回答
wonder 已知	想知道
open 已知	打开
Street 已知	翻译出错，请更新
Treasury 已知	翻译出错，请更新
afterwards 已知	之后
bring 已知	带来
further 已知	进一步
large 已知	大的
others 已知	其他人
passed 已知	通过
vote 已知	投票
Indeed 已知	翻译出错，请更新
accept 已知	接受
beginning 已知	开始
itself 已知	它自己
nearly 已知	几乎
offer 已知	提供
story 已知	故事
town 已知	城镇
ballot 已知	投票
daughter 已知	女儿
five 已知	五
friendship 已知	友谊
gave 已知	给
law 已知	法律
opportunity 已知	机会
regard 已知	尊重
youll 已知	翻译出错，请更新
future 已知	未来
met 已知	遇见
opinion 已知	意见
private 已知	私人的
real 已知	真实的
taking 已知	拿
talking 已知	谈论
Lauras 已知	翻译出错，请更新
learned 已知	学到
marriage 已知	婚姻
telling 已知	告诉
ten 已知	十
Ive 已知	翻译出错，请更新
became 已知	成为
difficulty 已知	困难
generally 已知	通常
hero 已知	英雄
pretty 已知	漂亮的
regarded 已知	被视为
sometimes 已知	有时
anxious 已知	焦虑的
cause 已知	原因
purpose 已知	目的
show 已知	展示
sister 已知	姐妹
Daubeny 已知	翻译出错，请更新
Portman 已知	翻译出错，请更新
Standish 已知	翻译出错，请更新
circumstances 已知	情况
comfort 已知	安慰
false 已知	错误的
feet 已知	脚
fortune 已知	命运
knowing 已知	知道
minutes 已知	分钟
support 已知	支持
week 已知	周
wished 已知	希望
Ministers 已知	翻译出错，请更新
Park 已知	翻译出错，请更新
Very 已知	翻译出错，请更新
family 已知	家庭
fashion 已知	时尚
forward 已知	向前
lost 已知	失去
reply 已知	回复
sent 已知	发送
short 已知	短的
Banner 已知	翻译出错，请更新
England 已知	翻译出错，请更新
anybody 已知	任何人
change 已知	改变
danger 已知	危险
kept 已知	保持
meeting 已知	会议
mother 已知	母亲
near 已知	接近
nevertheless 已知	尽管如此
nobody 已知	没有人
none 已知	没有一个
prepared 已知	准备好的
reading 已知	阅读
refused 已知	拒绝
Commons 已知	翻译出错，请更新
Let 已知	翻译出错，请更新
carry 已知	携带
fool 已知	傻瓜
horse 已知	马
says 已知	说
small 已知	小的
thus 已知	因此
turn 已知	转向
across 已知	穿过
answered 已知	回答
conversation 已知	对话
expected 已知	预期
expressed 已知	表达
honour 已知	荣誉
knows 已知	知道
lived 已知	生活
nature 已知	自然
opposition 已知	反对
reached 已知	到达
reference 已知	参考
sake 已知	缘故
sorry 已知	抱歉
comes 已知	来
easy 已知	容易的
except 已知	除了
legs 已知	腿
lover 已知	情人
mans 已知	人
months 已知	月份
order 已知	顺序、命令、订购等
quarrel 已知	争吵、吵架
seems 已知	似乎、好像
worse 已知	更坏的、更差的、恶化
Ah 已知	翻译出错，请更新
above 已知	翻译出错，请更新
case 已知	情况、案例、箱子
choose 已知	选择
club 已知	俱乐部、棍棒
fathers 已知	父亲
fight 已知	打架、战斗、斗争
public 已知	公众的、公共的、公开的
ready 已知	准备好的、乐意的
remain 已知	剩余、留下、仍然是
settled 已知	解决、定居、安定下来
whose 已知	谁的
Mildmays 已知	翻译出错，请更新
Nothing 已知	翻译出错，请更新
Thats 已知	翻译出错，请更新
arm 已知	手臂、武器
asking 已知	询问、要求
believed 已知	相信
broken 已知	破碎的、坏掉的
honest 已知	诚实的
liberal 已知	自由的、开明的、慷慨的
run 已知	跑、经营、运转
bear 已知	熊、忍受、承担
expect 已知	期待、期望
gentlemen 已知	绅士
giving 已知	给予
ground 已知	地面、土地、根据
ladies 已知	女士
liked 已知	喜欢
past 已知	过去的、经过、超过
promise 已知	承诺、诺言
sir 已知	先生、爵士
six 已知	六
spite 已知	恶意、怨恨
English 已知	翻译出错，请更新
Monks 已知	翻译出错，请更新
dine 已知	进餐、用餐
drawingroom 已知	客厅、休息室
exactly 已知	确切地、精确地
express 已知	表达、快递、快车
fancy 已知	想象、喜爱、奇特的
getting 已知	得到
hundred 已知	一百
intention 已知	意图、目的
interest 已知	兴趣、利益、利息
measure 已知	测量、措施、程度
opened 已知	打开
shilling 已知	先令
Dr 已知	翻译出错，请更新
Sir 已知	翻译出错，请更新
anger 已知	愤怒、生气
anyone 已知	任何人
black 已知	黑色、黑人、黑色的
carriage 已知	马车、运输、运费
hours 已知	小时（hour 的复数形式）
immediately 已知	立即、马上
profession 已知	职业、专业、声明
rich 已知	富有的、丰富的
send 已知	翻译出错，请更新
somewhat 已知	翻译出错，请更新
terrible 已知	翻译出错，请更新
useful 已知	翻译出错，请更新
accepted 已知	翻译出错，请更新
advice 已知	翻译出错，请更新
attempt 已知	翻译出错，请更新
carried 已知	翻译出错，请更新
chair 已知	翻译出错，请更新
paused 已知	翻译出错，请更新
point 已知	翻译出错，请更新
thousand 已知	翻译出错，请更新
times 已知	翻译出错，请更新
tone 已知	翻译出错，请更新
unhappy 已知	翻译出错，请更新
Quintus 已知	翻译出错，请更新
Tulla 已知	翻译出错，请更新
ambition 已知	翻译出错，请更新
beyond 已知	翻译出错，请更新
de 已知	翻译出错，请更新
dozen 已知	翻译出错，请更新
everybody 已知	翻译出错，请更新
explain 已知	解释
fond 已知	翻译出错，请更新
living 已知	翻译出错，请更新
longer 已知	翻译出错，请更新
makes 已知	翻译出错，请更新
matters 已知	翻译出错，请更新
obliged 已知	翻译出错，请更新
pay 已知	支付
pounds 已知	翻译出错，请更新
proud 已知	翻译出错，请更新
shown 已知	翻译出错，请更新
stay 已知	翻译出错，请更新
twenty 已知	翻译出错，请更新
wrote 已知	翻译出错，请更新
Dont 已知	翻译出错，请更新
Goeslers 已知	翻译出错，请更新
Prime 已知	翻译出错，请更新
Robert 已知	翻译出错，请更新
St 已知	翻译出错，请更新
affair 已知	翻译出错，请更新
behind 已知	背后
changed 已知	翻译出错，请更新
difference 已知	翻译出错，请更新
different 已知	翻译出错，请更新
favour 已知	翻译出错，请更新
husbands 已知	翻译出错，请更新
proposed 已知	翻译出错，请更新
questions 已知	翻译出错，请更新
seven 已知	七
spirit 已知	翻译出错，请更新
thoroughly 已知	翻译出错，请更新
tried 已知	翻译出错，请更新
whatever 已知	翻译出错，请更新
Terrier 已知	翻译出错，请更新
desire 已知	翻译出错，请更新
escape 已知	翻译出错，请更新
fire 已知	翻译出错，请更新
held 已知	翻译出错，请更新
hold 已知	翻译出错，请更新
oclock 已知	翻译出错，请更新
parliamentary 已知	翻译出错，请更新
pass 已知	翻译出错，请更新
pleasure 已知	翻译出错，请更新
respect 已知	翻译出错，请更新
returned 已知	翻译出错，请更新
ride 已知	翻译出错，请更新
servant 已知	翻译出错，请更新
set 已知	翻译出错，请更新
succeed 已知	翻译出错，请更新
Kennedys 已知	翻译出错，请更新
account 已知	翻译出错，请更新
ago 已知	翻译出错，请更新
becoming 已知	翻译出错，请更新
begin 已知	翻译出错，请更新
clever 已知	翻译出错，请更新
corner 已知	翻译出错，请更新
crowd 已知	翻译出错，请更新
driven 已知	翻译出错，请更新
earth 已知	翻译出错，请更新
election 已知	翻译出错，请更新
failed 已知	翻译出错，请更新
hes 已知	翻译出错，请更新
ideas 已知	翻译出错，请更新
mouth 已知	翻译出错，请更新
neither 已知	翻译出错，请更新
object 已知	翻译出错，请更新
please 已知	翻译出错，请更新
proper 已知	翻译出错，请更新
remained 已知	翻译出错，请更新
rooms 已知	翻译出错，请更新
secret 已知	翻译出错，请更新
successful 已知	翻译出错，请更新
suit 已知	翻译出错，请更新
trust 已知	翻译出错，请更新
waiting 已知	翻译出错，请更新
walk 已知	翻译出错，请更新
age 已知	翻译出错，请更新
allow 已知	允许
assistance 已知	翻译出错，请更新
difficult 已知	翻译出错，请更新
free 已知	翻译出错，请更新
horses 已知	翻译出错，请更新
moved 已知	翻译出错，请更新
occurred 已知	翻译出错，请更新
paid 已知	翻译出错，请更新
pleased 已知	翻译出错，请更新
quickly 已知	翻译出错，请更新
reader 已知	翻译出错，请更新
remembered 已知	翻译出错，请更新
service 已知	翻译出错，请更新
shouldnt 已知	翻译出错，请更新
table 已知	翻译出错，请更新
talked 已知	翻译出错，请更新
George 已知	翻译出错，请更新
Peoples 已知	翻译出错，请更新
beautiful 已知	翻译出错，请更新
dare 已知	翻译出错，请更新
engaged 已知	翻译出错，请更新
especially 已知	翻译出错，请更新
fall 已知	翻译出错，请更新
fallen 已知	翻译出错，请更新
goes 已知	翻译出错，请更新
government 已知	政府政体
hair 已知	翻译出错，请更新
month 已知	翻译出错，请更新
placed 已知	翻译出错，请更新
thrown 已知	翻译出错，请更新
willing 已知	翻译出错，请更新
Brentfords 已知	翻译出错，请更新
Lane 已知	翻译出错，请更新
declare 已知	翻译出错，请更新
division 已知	翻译出错，请更新
eye 已知	翻译出错，请更新
fit 已知	翻译出错，请更新
general 已知	翻译出错，请更新
intimate 已知	翻译出错，请更新
isnt 已知	翻译出错，请更新
leader 已知	翻译出错，请更新
moments 已知	翻译出错，请更新
papa 已知	翻译出错，请更新
person 已知	翻译出错，请更新
refuse 已知	翻译出错，请更新
regret 已知	翻译出错，请更新
sons 已知	翻译出错，请更新
throw 已知	翻译出错，请更新
worth 已知	翻译出错，请更新
Chilterns 已知	翻译出错，请更新
Duchess 已知	翻译出错，请更新
Dukes 已知	翻译出错，请更新
Grosvenor 已知	翻译出错，请更新
Perhaps 已知	翻译出错，请更新
Such 已知	翻译出错，请更新
bit 已知	翻译出错，请更新
clause 已知	条款
determined 已知	翻译出错，请更新
fair 已知	翻译出错，请更新
following 已知	翻译出错，请更新
honourable 已知	翻译出错，请更新
line 已知	翻译出错，请更新
lobby 已知	翻译出错，请更新
majority 已知	翻译出错，请更新
mine 已知	翻译出错，请更新
thoughts 已知	翻译出错，请更新
twice 已知	翻译出错，请更新
accusation 已知	翻译出错，请更新
beauty 已知	翻译出错，请更新
career 已知	翻译出错，请更新
child 已知	翻译出错，请更新
greatest 已知	翻译出错，请更新
intend 已知	翻译出错，请更新
meant 已知	翻译出错，请更新
plainly 已知	翻译出错，请更新
presence 已知	翻译出错，请更新
promised 已知	翻译出错，请更新
safe 已知	翻译出错，请更新
seem 已知	翻译出错，请更新
society 已知	翻译出错，请更新
wishes 已知	翻译出错，请更新
youre 已知	翻译出错，请更新
yours 已知	翻译出错，请更新
Club 已知	翻译出错，请更新
Place 已知	翻译出错，请更新
Thursday 已知	翻译出错，请更新
Tuesday 已知	翻译出错，请更新
aint 已知	翻译出错，请更新
arms 已知	翻译出错，请更新
chambers 已知	房间
desired 已知	翻译出错，请更新
earnest 已知	翻译出错，请更新
fine 已知	翻译出错，请更新
forget 已知	翻译出错，请更新
hopes 已知	翻译出错，请更新
ill 已知	生病的
influence 已知	翻译出错，请更新
join 已知	翻译出错，请更新
offered 已知	翻译出错，请更新
passion 已知	翻译出错，请更新
pause 已知	翻译出错，请更新
perceived 已知	翻译出错，请更新
quarrelled 已知	翻译出错，请更新
single 已知	翻译出错，请更新
supposed 已知	翻译出错，请更新
Barbara 已知	翻译出错，请更新
Bill 已知	翻译出错，请更新
Certainly 已知	翻译出错，请更新
Did 已知	翻译出错，请更新
Nor 已知	翻译出错，请更新
Though 已知	翻译出错，请更新
Wednesday 已知	翻译出错，请更新
afternoon 已知	翻译出错，请更新
arranged 已知	翻译出错，请更新
autumn 已知	翻译出错，请更新
county 已知	翻译出错，请更新
daresay 已知	翻译出错，请更新
entered 已知	翻译出错，请更新
excuse 已知	翻译出错，请更新
form 已知	翻译出错，请更新
lose 已知	翻译出错，请更新
nice 已知	翻译出错，请更新
pocket 已知	翻译出错，请更新
smile 已知	翻译出错，请更新
smiled 已知	翻译出错，请更新
specially 已知	翻译出错，请更新
spot 已知	翻译出错，请更新
walking 已知	翻译出错，请更新
Here 已知	翻译出错，请更新
Monday 已知	翻译出错，请更新
UnderSecretary 已知	翻译出错，请更新
along 已知	翻译出错，请更新
assured 已知	翻译出错，请更新
bench 已知	翻译出错，请更新
cared 已知	翻译出错，请更新
chosen 已知	翻译出错，请更新
comfortable 已知	翻译出错，请更新
ears 已知	翻译出错，请更新
explained 已知	翻译出错，请更新
generous 已知	翻译出错，请更新
girls 已知	翻译出错，请更新
interview 已知	翻译出错，请更新
leaving 已知	翻译出错，请更新
motion 已知	翻译出错，请更新
nine 已知	翻译出错，请更新
period 已知	翻译出错，请更新
personal 已知	翻译出错，请更新
required 已知	翻译出错，请更新
silent 已知	翻译出错，请更新
someone 已知	某人
stick 已知	翻译出错，请更新
sympathy 已知	翻译出错，请更新
top 已知	翻译出错，请更新
wait 已知	翻译出错，请更新
wealth 已知	翻译出错，请更新
welcome 已知	翻译出错，请更新
Baldocks 已知	翻译出错，请更新
Chancellor 已知	翻译出错，请更新
May 已知	翻译出错，请更新
Men 已知	翻译出错，请更新
Never 已知	翻译出错，请更新
Tell 已知	翻译出错，请更新
Willingford 已知	翻译出错，请更新
acknowledged 已知	翻译出错，请更新
around 已知	翻译出错，请更新
attack 已知	翻译出错，请更新
battle 已知	翻译出错，请更新
discussed 已知	翻译出错，请更新
fault 已知	翻译出错，请更新
followed 已知	翻译出错，请更新
guests 已知	翻译出错，请更新
hitherto 已知	翻译出错，请更新
invitation 已知	翻译出错，请更新
laughing 已知	翻译出错，请更新
middle 已知	翻译出错，请更新
perceive 已知	翻译出错，请更新
places 已知	翻译出错，请更新
receive 已知	翻译出错，请更新
seated 已知	翻译出错，请更新
shoulders 已知	翻译出错，请更新
swore 已知	翻译出错，请更新
tells 已知	翻译出错，请更新
thinks 已知	翻译出错，请更新
third 已知	翻译出错，请更新
various 已知	翻译出错，请更新
wants 已知	翻译出错，请更新
worst 已知	翻译出错，请更新
Dublin 已知	翻译出错，请更新
Earls 已知	翻译出错，请更新
Grace 已知	翻译出错，请更新
Office 已知	翻译出错，请更新
Westminster 已知	翻译出错，请更新
acknowledge 已知	翻译出错，请更新
act 已知	翻译出错，请更新
admit 已知	翻译出错，请更新
argument 已知	翻译出错，请更新
bed 已知	翻译出错，请更新
behalf 已知	翻译出错，请更新
below 已知	翻译出错，请更新
big 已知	翻译出错，请更新
card 已知	翻译出错，请更新
clear 已知	翻译出错，请更新
command 已知	翻译出错，请更新
confidence 已知	翻译出错，请更新
dark 已知	翻译出错，请更新
dearest 已知	翻译出错，请更新
difficulties 已知	翻译出错，请更新
due 已知	翻译出错，请更新
effect 已知	翻译出错，请更新
endeavour 已知	翻译出错，请更新
engagement 已知	翻译出错，请更新
evil 已知	翻译出错，请更新
fail 已知	翻译出错，请更新
feelings 已知	翻译出错，请更新
fixed 已知	翻译出错，请更新
headache 已知	头痛
hell 已知	翻译出错，请更新
journey 已知	翻译出错，请更新
language 已知	翻译出错，请更新
learn 已知	翻译出错，请更新
likely 已知	翻译出错，请更新
lords 已知	翻译出错，请更新
named 已知	翻译出错，请更新
news 已知	翻译出错，请更新
reach 已知	翻译出错，请更新
shoulder 已知	翻译出错，请更新
showed 已知	翻译出错，请更新
summer 已知	翻译出错，请更新
sweet 已知	翻译出错，请更新
task 已知	翻译出错，请更新
th 已知	翻译出错，请更新
twelve 已知	翻译出错，请更新
uncle 已知	翻译出错，请更新
Are 已知	翻译出错，请更新
Finns 已知	翻译出错，请更新
Turnbulls 已知	翻译出错，请更新
Yours 已知	翻译出错，请更新
abandon 已知	翻译出错，请更新
arrangement 已知	翻译出错，请更新
article 已知	翻译出错，请更新
break 已知	翻译出错，请更新
careful 已知	翻译出错，请更新
company 已知	翻译出错，请更新
concerned 已知	翻译出错，请更新
conduct 已知	翻译出错，请更新
consent 已知	翻译出错，请更新
cottage 已知	翻译出错，请更新
didnt 已知	翻译出错，请更新
gained 已知	翻译出错，请更新
gets 已知	翻译出错，请更新
hoped 已知	翻译出错，请更新
independent 已知	翻译出错，请更新
interfere 已知	翻译出错，请更新
lake 已知	翻译出错，请更新
letters 已知	翻译出错，请更新
likes 已知	翻译出错，请更新
lips 已知	翻译出错，请更新
niece 已知	翻译出错，请更新
odd 已知	翻译出错，请更新
official 已知	翻译出错，请更新
particular 已知	翻译出错，请更新
perfect 已知	翻译出错，请更新
police 已知	翻译出错，请更新
possibly 已知	翻译出错，请更新
privilege 已知	翻译出错，请更新
rest 已知	翻译出错，请更新
silence 已知	翻译出错，请更新
step 已知	翻译出错，请更新
tired 已知	翻译出错，请更新
visit 已知	翻译出错，请更新
wretched 已知	翻译出错，请更新
Bonebreaker 已知	翻译出错，请更新
DEAR 已知	翻译出错，请更新
God 已知	翻译出错，请更新
Since 已知	翻译出错，请更新
State 已知	翻译出错，请更新
absolutely 已知	翻译出错，请更新
begun 已知	翻译出错，请更新
bid 已知	翻译出错，请更新
books 已知	翻译出错，请更新
boroughs 已知	翻译出错，请更新
character 已知	翻译出错，请更新
deny 已知	翻译出错，请更新
dined 已知	翻译出错，请更新
effort 已知	翻译出错，请更新
equal 已知	翻译出错，请更新
forgotten 已知	翻译出错，请更新
game 已知	翻译出错，请更新
hat 已知	翻译出错，请更新
indifferent 已知	翻译出错，请更新
lodgings 已知	翻译出错，请更新
lot 已知	翻译出错，请更新
opposite 已知	翻译出错，请更新
park 已知	公园
parties 已知	翻译出错，请更新
peer 已知	翻译出错，请更新
prevent 已知	翻译出错，请更新
red 已知	红色
result 已知	翻译出错，请更新
rising 已知	翻译出错，请更新
rival 已知	翻译出错，请更新
rode 已知	翻译出错，请更新
sad 已知	翻译出错，请更新
seeing 已知	翻译出错，请更新
sisters 已知	翻译出错，请更新
soft 已知	翻译出错，请更新
sooner 已知	翻译出错，请更新
speeches 已知	翻译出错，请更新
succeeded 已知	翻译出错，请更新
surprised 已知	翻译出错，请更新
terms 已知	翻译出错，请更新
turning 已知	翻译出错，请更新
vain 已知	翻译出错，请更新
whereas 已知	翻译出错，请更新
August 已知	翻译出错，请更新
Blankenberg 已知	翻译出错，请更新
Committee 已知	翻译出错，请更新
Dear 已知	翻译出错，请更新
Friday 已知	翻译出错，请更新
Lords 已知	翻译出错，请更新
Lows 已知	翻译出错，请更新
Morris 已知	翻译出错，请更新
Nevertheless 已知	翻译出错，请更新
Secretary 已知	翻译出错，请更新
accident 已知	翻译出错，请更新
address 已知	翻译出错，请更新
affairs 已知	事务
beneath 已知	翻译出错，请更新
church 已知	翻译出错，请更新
cousin 已知	翻译出错，请更新
cut 已知	翻译出错，请更新
decision 已知	翻译出错，请更新
delighted 已知	翻译出错，请更新
fifty 已知	翻译出错，请更新
force 已知	翻译出错，请更新
fought 已知	翻译出错，请更新
frequently 已知	翻译出错，请更新
grand 已知	翻译出错，请更新
handsome 已知	翻译出错，请更新
hunting 已知	翻译出错，请更新
hurry 已知	翻译出错，请更新
income 已知	翻译出错，请更新
instantly 已知	翻译出错，请更新
laws 已知	翻译出错，请更新
mode 已知	翻译出错，请更新
necessity 已知	翻译出错，请更新
occasions 已知	翻译出错，请更新
otherwise 已知	翻译出错，请更新
peas 已知	翻译出错，请更新
press 已知	翻译出错，请更新
proposition 已知	翻译出错，请更新
repeated 已知	翻译出错，请更新
resolution 已知	翻译出错，请更新
respecting 已知	关于
secretary 已知	翻译出错，请更新
severe 已知	翻译出错，请更新
shook 已知	翻译出错，请更新
tongue 已知	翻译出错，请更新
understanding 已知	翻译出错，请更新
violent 已知	翻译出错，请更新
ways 已知	方法
weak 已知	翻译出错，请更新
winter 已知	翻译出错，请更新
wrath 已知	翻译出错，请更新
Liberal 已知	翻译出错，请更新
Linter 已知	翻译出错，请更新
Majesty 已知	翻译出错，请更新
Plantagenet 已知	翻译出错，请更新
advantage 已知	翻译出错，请更新
agree 已知	翻译出错，请更新
barrister 已知	翻译出错，请更新
bread 已知	翻译出错，请更新
breakfast 已知	翻译出错，请更新
bright 已知	翻译出错，请更新
brothers 已知	翻译出错，请更新
candidate 已知	翻译出错，请更新
civil 已知	翻译出错，请更新
committee 已知	翻译出错，请更新
common 已知	翻译出错，请更新
courage 已知	翻译出错，请更新
glory 已知	翻译出错，请更新
grace 已知	翻译出错，请更新
gracious 已知	翻译出错，请更新
hate 已知	翻译出错，请更新
lately 已知	翻译出错，请更新
loving 已知	翻译出错，请更新
meaning 已知	翻译出错，请更新
natural 已知	翻译出错，请更新
nonsense 已知	翻译出错，请更新
ordinary 已知	翻译出错，请更新
popular 已知	翻译出错，请更新
possessed 已知	翻译出错，请更新
propose 已知	翻译出错，请更新
prospects 已知	翻译出错，请更新
require 已知	翻译出错，请更新
resign 已知	辞职
salary 已知	翻译出错，请更新
save 已知	翻译出错，请更新
seats 已知	翻译出错，请更新
servants 已知	翻译出错，请更新
sharp 已知	翻译出错，请更新
sore 已知	翻译出错，请更新
sound 已知	翻译出错，请更新
start 已知	翻译出错，请更新
state 已知	翻译出错，请更新
staying 已知	翻译出错，请更新
touch 已知	翻译出错，请更新
touched 已知	翻译出错，请更新
views 已知	翻译出错，请更新
water 已知	翻译出错，请更新
writing 已知	翻译出错，请更新
Augusta 已知	翻译出错，请更新
During 已知	翻译出错，请更新
July 已知	翻译出错，请更新
March 已知	翻译出错，请更新
Poor 已知	翻译出错，请更新
affection 已知	翻译出错，请更新
amount 已知	翻译出错，请更新
aside 已知	翻译出错，请更新
assist 已知	翻译出错，请更新
badly 已知	翻译出错，请更新
blow 已知	翻译出错，请更新
bosom 已知	翻译出错，请更新
chose 已知	翻译出错，请更新
clubs 已知	翻译出错，请更新
cold 已知	翻译出错，请更新
cruel 已知	翻译出错，请更新
dangerous 已知	翻译出错，请更新
decent 已知	翻译出错，请更新
die 已知	翻译出错，请更新
doubted 已知	翻译出错，请更新
electors 已知	翻译出错，请更新
equally 已知	翻译出错，请更新
evidence 已知	翻译出错，请更新
failure 已知	翻译出错，请更新
foolish 已知	翻译出错，请更新
foot 已知	翻译出错，请更新
forty 已知	翻译出错，请更新
greater 已知	翻译出错，请更新
happened 已知	翻译出错，请更新
hated 已知	翻译出错，请更新
heavy 已知	翻译出错，请更新
judge 已知	翻译出错，请更新
lay 已知	翻译出错，请更新
led 已知	翻译出错，请更新
listen 已知	翻译出错，请更新
lovers 已知	翻译出错，请更新
loves 已知	翻译出错，请更新
opening 已知	翻译出错，请更新
pity 已知	翻译出错，请更新
play 已知	翻译出错，请更新
prefer 已知	翻译出错，请更新
pressed 已知	翻译出错，请更新
pride 已知	翻译出错，请更新
putting 已知	翻译出错，请更新
quick 已知	翻译出错，请更新
ruin 已知	翻译出错，请更新
scene 已知	翻译出错，请更新
sense 已知	翻译出错，请更新
slowly 已知	翻译出错，请更新
sorrow 已知	翻译出错，请更新
strength 已知	翻译出错，请更新
sufficient 已知	翻译出错，请更新
temptation 已知	翻译出错，请更新
thats 已知	那是
unable 已知	翻译出错，请更新
untrue 已知	翻译出错，请更新
venture 已知	翻译出错，请更新
wonderful 已知	翻译出错，请更新
British 已知	翻译出错，请更新
Bungay 已知	翻译出错，请更新
Everybody 已知	翻译出错，请更新
Inn 已知	翻译出错，请更新
although 已知	翻译出错，请更新
anxiety 已知	翻译出错，请更新
appointment 已知	翻译出错，请更新
ashamed 已知	翻译出错，请更新
attention 已知	翻译出错，请更新
beg 已知	翻译出错，请更新
born 已知	翻译出错，请更新
children 已知	孩子们
complain 已知	翻译出错，请更新
confess 已知	翻译出错，请更新
consider 已知	翻译出错，请更新
coronet 已知	翻译出错，请更新
debt 已知	翻译出错，请更新
direct 已知	翻译出错，请更新
disagreeable 已知	翻译出错，请更新
dull 已知	翻译出错，请更新
eight 已知	翻译出错，请更新
em 已知	翻译出错，请更新
expression 已知	翻译出错，请更新
favourite 已知	翻译出错，请更新
ignorant 已知	翻译出错，请更新
instead 已知	翻译出错，请更新
invited 已知	翻译出错，请更新
joined 已知	翻译出错，请更新
joy 已知	翻译出错，请更新
leading 已知	翻译出错，请更新
master 已知	翻译出错，请更新
mistress 已知	翻译出错，请更新
mountain 已知	翻译出错，请更新
parted 已知	翻译出错，请更新
property 已知	翻译出错，请更新
reputation 已知	翻译出错，请更新
risk 已知	翻译出错，请更新
river 已知	翻译出错，请更新
shoot 已知	翻译出错，请更新
shot 已知	翻译出错，请更新
slow 已知	翻译出错，请更新
sofa 已知	翻译出错，请更新
strongly 已知	翻译出错，请更新
surely 已知	当然
today 已知	翻译出错，请更新
trying 已知	翻译出错，请更新
yesterday 已知	翻译出错，请更新
Bar 已知	翻译出错，请更新
Christmas 已知	翻译出错，请更新
Downing 已知	翻译出错，请更新
Goodbye 已知	翻译出错，请更新
Great 已知	翻译出错，请更新
Hes 已知	翻译出错，请更新
Queen 已知	翻译出错，请更新
Upon 已知	翻译出错，请更新
Whig 已知	翻译出错，请更新
air 已知	翻译出错，请更新
avoid 已知	翻译出错，请更新
becomes 已知	翻译出错，请更新
bitter 已知	翻译出错，请更新
bore 已知	翻译出错，请更新
brow 已知	翻译出错，请更新
clearly 已知	翻译出错，请更新
conviction 已知	翻译出错，请更新
deeply 已知	翻译出错，请更新
demanded 已知	翻译出错，请更新
distance 已知	翻译出错，请更新
ear 已知	翻译出错，请更新
earn 已知	翻译出错，请更新
eat 已知	翻译出错，请更新
eleven 已知	翻译出错，请更新
fellows 已知	翻译出错，请更新
hall 已知	翻译出错，请更新
houses 已知	翻译出错，请更新
latter 已知	翻译出错，请更新
loud 已知	翻译出错，请更新
meantime 已知	翻译出错，请更新
minds 已知	翻译出错，请更新
mistake 已知	翻译出错，请更新
notice 已知	翻译出错，请更新
number 已知	翻译出错，请更新
ones 已知	翻译出错，请更新
opinions 已知	翻译出错，请更新
paper 已知	翻译出错，请更新
potted 已知	翻译出错，请更新
promotion 已知	翻译出错，请更新
punctual 已知	翻译出错，请更新
quiet 已知	翻译出错，请更新
rank 已知	翻译出错，请更新
reasons 已知	翻译出错，请更新
request 已知	翻译出错，请更新
resignation 已知	翻译出错，请更新
romance 已知	翻译出错，请更新
rough 已知	翻译出错，请更新
shake 已知	翻译出错，请更新
showing 已知	显示
smiling 已知	翻译出错，请更新
somebody 已知	翻译出错，请更新
somewhere 已知	翻译出错，请更新
spent 已知	翻译出错，请更新
surprise 已知	翻译出错，请更新
swear 已知	翻译出错，请更新
temper 已知	翻译出错，请更新
tenantright 已知	翻译出错，请更新
thirty 已知	翻译出错，请更新
tidings 已知	翻译出错，请更新
treated 已知	翻译出错，请更新
triumph 已知	翻译出错，请更新
upstairs 已知	翻译出错，请更新
welfare 已知	翻译出错，请更新
window 已知	翻译出错，请更新
wise 已知	翻译出错，请更新
won 已知	翻译出错，请更新
wouldnt 已知	不会
youth 已知	翻译出错，请更新
Bunces 已知	翻译出错，请更新
Effinghams 已知	翻译出错，请更新
February 已知	翻译出错，请更新
Greshams 已知	翻译出错，请更新
Lincolns 已知	翻译出错，请更新
Nay 已知	翻译出错，请更新
accused 已知	翻译出错，请更新
action 已知	翻译出错，请更新
admitted 已知	翻译出错，请更新
afford 已知	翻译出错，请更新
arguments 已知	翻译出错，请更新
arrival 已知	翻译出错，请更新
assure 已知	翻译出错，请更新
blood 已知	翻译出错，请更新
blushed 已知	翻译出错，请更新
bringing 已知	翻译出错，请更新
cab 已知	翻译出错，请更新
charming 已知	翻译出错，请更新
choice 已知	翻译出错，请更新
closely 已知	翻译出错，请更新
colour 已知	翻译出错，请更新
companion 已知	翻译出错，请更新
conscious 已知	翻译出错，请更新
considerable 已知	翻译出错，请更新
countenance 已知	翻译出错，请更新
d 已知	翻译出错，请更新
delight 已知	翻译出错，请更新
dislike 已知	翻译出错，请更新
disposed 已知	翻译出错，请更新
dress 已知	翻译出错，请更新
duke 已知	公爵
enemies 已知	翻译出错，请更新
excellent 已知	翻译出错，请更新
excitement 已知	翻译出错，请更新
fast 已知	翻译出错，请更新
feared 已知	翻译出错，请更新
follows 已知	翻译出错，请更新
hot 已知	翻译出错，请更新
importance 已知	翻译出错，请更新
injury 已知	翻译出错，请更新
inn 已知	翻译出错，请更新
instance 已知	翻译出错，请更新
keeping 已知	翻译出错，请更新
knowledge 已知	翻译出错，请更新
land 已知	翻译出错，请更新
laugh 已知	翻译出错，请更新
lives 已知	翻译出错，请更新
longed 已知	翻译出错，请更新
memory 已知	翻译出错，请更新
mentioned 已知	翻译出错，请更新
merely 已知	翻译出错，请更新
miles 已知	翻译出错，请更新
nearer 已知	翻译出错，请更新
neck 已知	翻译出错，请更新
nephew 已知	翻译出错，请更新
ourselves 已知	翻译出错，请更新
perfectly 已知	翻译出错，请更新
plan 已知	翻译出错，请更新
porter 已知	翻译出错，请更新
prospect 已知	翻译出错，请更新
pupil 已知	翻译出错，请更新
reconciled 已知	翻译出错，请更新
satisfied 已知	翻译出错，请更新
slightest 已知	翻译出错，请更新
soul 已知	翻译出错，请更新
spend 已知	翻译出错，请更新
spring 已知	翻译出错，请更新
statement 已知	翻译出错，请更新
stopped 已知	翻译出错，请更新
study 已知	翻译出错，请更新
sudden 已知	翻译出错，请更新
taught 已知	翻译出错，请更新
tears 已知	翻译出错，请更新
usual 已知	翻译出错，请更新
uttered 已知	翻译出错，请更新
votes 已知	翻译出错，请更新
whisper 已知	翻译出错，请更新
whispered 已知	翻译出错，请更新
wisdom 已知	翻译出错，请更新
worked 已知	翻译出错，请更新
working 已知	翻译出错，请更新
Bull 已知	翻译出错，请更新
Colonial 已知	翻译出错，请更新
Conservative 已知	翻译出错，请更新
Id 已知	翻译出错，请更新
Macnuthrie 已知	翻译出错，请更新
Marie 已知	翻译出错，请更新
Matching 已知	翻译出错，请更新
Radical 已知	翻译出错，请更新
Should 已知	翻译出错，请更新
addressing 已知	翻译出错，请更新
appeared 已知	翻译出错，请更新
assurance 已知	翻译出错，请更新
belief 已知	翻译出错，请更新
belonged 已知	翻译出错，请更新
benches 已知	翻译出错，请更新
blue 已知	翻译出错，请更新
breast 已知	翻译出错，请更新
charge 已知	翻译出错，请更新
charm 已知	翻译出错，请更新
colonies 已知	翻译出错，请更新
couldnt 已知	翻译出错，请更新
couple 已知	翻译出错，请更新
credit 已知	翻译出错，请更新
crowded 已知	翻译出错，请更新
decided 已知	翻译出错，请更新
declaring 已知	翻译出错，请更新
decline 已知	翻译出错，请更新
demand 已知	翻译出错，请更新
devil 已知	翻译出错，请更新
disappointed 已知	翻译出错，请更新
discussion 已知	翻译出错，请更新
doctors 已知	翻译出错，请更新
drink 已知	翻译出错，请更新
eager 已知	翻译出错，请更新
easily 已知	翻译出错，请更新
expense 已知	翻译出错，请更新
fighting 已知	翻译出错，请更新
former 已知	翻译出错，请更新
franchise 已知	翻译出错，请更新
front 已知	翻译出错，请更新
garden 已知	花园
gratified 已知	翻译出错，请更新
grouse 已知	翻译出错，请更新
happiness 已知	翻译出错，请更新
heir 已知	翻译出错，请更新
higher 已知	翻译出错，请更新
history 已知	翻译出错，请更新
idle 已知	翻译出错，请更新
important 已知	翻译出错，请更新
intimacy 已知	翻译出错，请更新
judgment 已知	翻译出错，请更新
junior 已知	翻译出错，请更新
light 已知	翻译出错，请更新
list 已知	翻译出错，请更新
lordship 已知	翻译出错，请更新
low 已知	翻译出错，请更新
manage 已知	翻译出错，请更新
marrying 已知	翻译出错，请更新
ministers 已知	部长
obedience 已知	翻译出错，请更新
owed 已知	翻译出错，请更新
partly 已知	翻译出错，请更新
path 已知	翻译出错，请更新
peers 已知	翻译出错，请更新
plenty 已知	翻译出错，请更新
probable 已知	翻译出错，请更新
reform 已知	改革改良
representative 已知	翻译出错，请更新
resolving 已知	翻译出错，请更新
riding 已知	翻译出错，请更新
season 已知	翻译出错，请更新
serious 已知	翻译出错，请更新
serve 已知	翻译出错，请更新
shant 已知	翻译出错，请更新
slight 已知	翻译出错，请更新
steady 已知	翻译出错，请更新
stiff 已知	翻译出错，请更新
subjects 已知	翻译出错，请更新
throat 已知	翻译出错，请更新
tonight 已知	翻译出错，请更新
trade 已知	翻译出错，请更新
useless 已知	翻译出错，请更新
violence 已知	翻译出错，请更新
weeks 已知	翻译出错，请更新
white 已知	白色
wound 已知	翻译出错，请更新
youve 已知	翻译出错，请更新
Blood 已知	翻译出错，请更新
Brookss 已知	翻译出错，请更新
Conservatives 已知	翻译出错，请更新
Duchy 已知	翻译出错，请更新
Gustavus 已知	翻译出错，请更新
Has 已知	翻译出错，请更新
Papa 已知	翻译出错，请更新
Saturday 已知	翻译出错，请更新
Violets 已知	翻译出错，请更新
Whatever 已知	翻译出错，请更新
absurd 已知	翻译出错，请更新
according 已知	翻译出错，请更新
acquaintance 已知	翻译出错，请更新
armchair 已知	翻译出错，请更新
arrived 已知	翻译出错，请更新
assent 已知	翻译出错，请更新
awkward 已知	翻译出错，请更新
beaten 已知	翻译出错，请更新
caught 已知	翻译出错，请更新
charms 已知	翻译出错，请更新
conscience 已知	翻译出错，请更新
consented 已知	翻译出错，请更新
control 已知	翻译出错，请更新
counsel 已知	翻译出错，请更新
creature 已知	翻译出错，请更新
dared 已知	翻译出错，请更新
dead 已知	翻译出错，请更新
degree 已知	翻译出错，请更新
degrees 已知	翻译出错，请更新
desirable 已知	翻译出错，请更新
despise 已知	翻译出错，请更新
dining 已知	翻译出错，请更新
direction 已知	翻译出错，请更新
dog 已知	翻译出错，请更新
endeavoured 已知	翻译出错，请更新
entirely 已知	翻译出错，请更新
faith 已知	翻译出错，请更新
fate 已知	翻译出错，请更新
filled 已知	翻译出错，请更新
finding 已知	翻译出错，请更新
fingers 已知	翻译出错，请更新
follow 已知	翻译出错，请更新
forced 已知	翻译出错，请更新
forgot 已知	翻译出错，请更新
friendly 已知	翻译出错，请更新
harm 已知	翻译出错，请更新
heros 已知	翻译出错，请更新
hers 已知	翻译出错，请更新
holding 已知	翻译出错，请更新
host 已知	翻译出错，请更新
hounds 已知	翻译出错，请更新
inclined 已知	翻译出错，请更新
information 已知	翻译出错，请更新
justify 已知	翻译出错，请更新
killed 已知	翻译出错，请更新
labour 已知	翻译出错，请更新
later 已知	后来
length 已知	翻译出错，请更新
listened 已知	翻译出错，请更新
luck 已知	翻译出错，请更新
maintain 已知	翻译出错，请更新
mamma 已知	翻译出错，请更新
melancholy 已知	翻译出错，请更新
mention 已知	翻译出错，请更新
minute 已知	翻译出错，请更新
misfortune 已知	翻译出错，请更新
nobleman 已知	翻译出错，请更新
occur 已知	翻译出错，请更新
papers 已知	翻译出错，请更新
passing 已知	翻译出错，请更新
persons 已知	翻译出错，请更新
plain 已知	翻译出错，请更新
playing 已知	翻译出错，请更新
points 已知	翻译出错，请更新
policeman 已知	翻译出错，请更新
politician 已知	翻译出错，请更新
pony 已知	翻译出错，请更新
pretend 已知	翻译出错，请更新
produce 已知	翻译出错，请更新
produced 已知	翻译出错，请更新
propriety 已知	翻译出错，请更新
prudence 已知	翻译出错，请更新
quarter 已知	翻译出错，请更新
resigned 已知	翻译出错，请更新
respectable 已知	翻译出错，请更新
rose 已知	翻译出错，请更新
ruined 已知	翻译出错，请更新
satisfaction 已知	翻译出错，请更新
seldom 已知	翻译出错，请更新
sight 已知	翻译出错，请更新
stairs 已知	翻译出错，请更新
started 已知	翻译出错，请更新
steps 已知	翻译出错，请更新
train 已知	翻译出错，请更新
undertake 已知	翻译出错，请更新
unfortunate 已知	翻译出错，请更新
unlike 已知	翻译出错，请更新
weight 已知	翻译出错，请更新
win 已知	翻译出错，请更新
wit 已知	翻译出错，请更新
wood 已知	翻译出错，请更新
worthy 已知	翻译出错，请更新
Before 已知	翻译出错，请更新
Boreham 已知	翻译出错，请更新
Captain 已知	翻译出错，请更新
Crown 已知	翻译出错，请更新
Easter 已知	翻译出错，请更新
Every 已知	翻译出错，请更新
FINN 已知	翻译出错，请更新
Floodborough 已知	翻译出错，请更新
Marlborough 已知	翻译出错，请更新
Ratlers 已知	翻译出错，请更新
Scotland 已知	翻译出错，请更新
Simply 已知	翻译出错，请更新
Stackpoole 已知	翻译出错，请更新
Where 已知	翻译出错，请更新
Whether 已知	翻译出错，请更新
Youll 已知	翻译出错，请更新
absence 已知	翻译出错，请更新
accordance 已知	翻译出错，请更新
addressed 已知	翻译出错，请更新
affectionate 已知	翻译出错，请更新
agreed 已知	翻译出错，请更新
ambitious 已知	翻译出错，请更新
announced 已知	翻译出错，请更新
apology 已知	翻译出错，请更新
appearance 已知	翻译出错，请更新
aristocratic 已知	翻译出错，请更新
asserted 已知	翻译出错，请更新
attempted 已知	翻译出错，请更新
behaved 已知	翻译出错，请更新
bishop 已知	主教
book 已知	翻译出错，请更新
brick 已知	翻译出错，请更新
brute 已知	翻译出错，请更新
capable 已知	翻译出错，请更新
caution 已知	翻译出错，请更新
chamber 已知	翻译出错，请更新
closed 已知	翻译出错，请更新
colleagues 已知	翻译出错，请更新
completed 已知	翻译出错，请更新
consideration 已知	翻译出错，请更新
considered 已知	翻译出错，请更新
constant 已知	翻译出错，请更新
contented 已知	翻译出错，请更新
convictions 已知	翻译出错，请更新
daily 已知	翻译出错，请更新
daughters 已知	翻译出错，请更新
dearly 已知	翻译出错，请更新
death 已知	翻译出错，请更新
dinners 已知	翻译出错，请更新
disgrace 已知	翻译出错，请更新
drop 已知	翻译出错，请更新
ease 已知	翻译出错，请更新
eloquence 已知	翻译出错，请更新
ended 已知	翻译出错，请更新
endure 已知	翻译出错，请更新
estimation 已知	翻译出错，请更新
forgive 已知	翻译出错，请更新
gift 已知	翻译出错，请更新
gives 已知	翻译出错，请更新
green 已知	翻译出错，请更新
habit 已知	翻译出错，请更新
heartily 已知	翻译出错，请更新
induce 已知	翻译出错，请更新
injured 已知	翻译出错，请更新
inside 已知	翻译出错，请更新
interests 已知	翻译出错，请更新
kiss 已知	翻译出错，请更新
laid 已知	翻译出错，请更新
looks 已知	翻译出错，请更新
misery 已知	翻译出错，请更新
mystery 已知	翻译出错，请更新
offence 已知	翻译出错，请更新
offended 已知	翻译出错，请更新
particularly 已知	翻译出错，请更新
peace 已知	翻译出错，请更新
peoples 已知	翻译出错，请更新
personally 已知	翻译出错，请更新
plans 已知	翻译出错，请更新
ran 已知	翻译出错，请更新
remark 已知	翻译出错，请更新
rid 已知	翻译出错，请更新
rights 已知	翻译出错，请更新
road 已知	翻译出错，请更新
running 已知	翻译出错，请更新
score 已知	翻译出错，请更新
settle 已知	翻译出错，请更新
ship 已知	翻译出错，请更新
sick 已知	翻译出错，请更新
sin 已知	翻译出错，请更新
social 已知	翻译出错，请更新
softness 已知	翻译出错，请更新
street 已知	街道
streets 已知	翻译出错，请更新
sufficiently 已知	翻译出错，请更新
taste 已知	翻译出错，请更新
teeth 已知	翻译出错，请更新
theres 已知	翻译出错，请更新
threw 已知	翻译出错，请更新
unmarried 已知	翻译出错，请更新
unnecessary 已知	翻译出错，请更新
unpleasant 已知	翻译出错，请更新
visitor 已知	翻译出错，请更新
wear 已知	翻译出错，请更新
wild 已知	翻译出错，请更新
womans 已知	翻译出错，请更新
Again 已知	翻译出错，请更新
Appledom 已知	翻译出错，请更新
Bonteens 已知	翻译出错，请更新
Does 已知	翻译出错，请更新
Everard 已知	翻译出错，请更新
Fitzgibbons 已知	翻译出错，请更新
German 已知	翻译出错，请更新
Hall 已知	翻译出错，请更新
Jamess 已知	翻译出错，请更新
Limerick 已知	翻译出错，请更新
Marmaduke 已知	翻译出错，请更新
Mind 已知	翻译出错，请更新
Ministry 已知	翻译出错，请更新
Moronis 已知	翻译出错，请更新
Pallisers 已知	翻译出错，请更新
Paris 已知	翻译出错，请更新
Pray 已知	翻译出错，请更新
Protestant 已知	翻译出错，请更新
Queens 已知	翻译出错，请更新
Scotch 已知	翻译出错，请更新
Speaker 已知	翻译出错，请更新
Still 已知	翻译出错，请更新
Thank 已知	翻译出错，请更新
Tory 已知	翻译出错，请更新
Were 已知	翻译出错，请更新
accustomed 已知	翻译出错，请更新
achieved 已知	翻译出错，请更新
acted 已知	翻译出错，请更新
advanced 已知	翻译出错，请更新
advise 已知	翻译出错，请更新
alive 已知	翻译出错，请更新
annoyed 已知	翻译出错，请更新
arrangements 已知	翻译出错，请更新
ass 已知	翻译出错，请更新
attached 已知	翻译出错，请更新
bank 已知	翻译出错，请更新
barristers 已知	翻译出错，请更新
boat 已知	翻译出错，请更新
body 已知	翻译出错，请更新
cards 已知	翻译出错，请更新
coat 已知	翻译出错，请更新
connection 已知	翻译出错，请更新
cost 已知	翻译出错，请更新
counted 已知	翻译出错，请更新
counties 已知	翻译出错，请更新
cry 已知	翻译出错，请更新
dance 已知	翻译出错，请更新
decide 已知	翻译出错，请更新
delightful 已知	翻译出错，请更新
departure 已知	翻译出错，请更新
dignity 已知	翻译出错，请更新
diningroom 已知	翻译出错，请更新
discuss 已知	翻译出错，请更新
dismay 已知	翻译出错，请更新
distasteful 已知	翻译出错，请更新
drive 已知	翻译出错，请更新
earned 已知	翻译出错，请更新
encountered 已知	翻译出错，请更新
energy 已知	翻译出错，请更新
existed 已知	翻译出错，请更新
experience 已知	翻译出错，请更新
fancied 已知	翻译出错，请更新
fell 已知	翻译出错，请更新
forth 已知	翻译出错，请更新
gain 已知	翻译出错，请更新
gathering 已知	翻译出错，请更新
gradually 已知	翻译出错，请更新
grateful 已知	翻译出错，请更新
greatly 已知	翻译出错，请更新
guest 已知	翻译出错，请更新
havent 已知	翻译出错，请更新
hearing 已知	翻译出错，请更新
heat 已知	翻译出错，请更新
human 已知	翻译出错，请更新
hurt 已知	翻译出错，请更新
idolatry 已知	翻译出错，请更新
imagine 已知	翻译出错，请更新
improper 已知	翻译出错，请更新
independence 已知	翻译出错，请更新
inquiry 已知	翻译出错，请更新
introduced 已知	翻译出错，请更新
joint 已知	翻译出错，请更新
kill 已知	翻译出错，请更新
knees 已知	翻译出错，请更新
ladys 已知	翻译出错，请更新
laughed 已知	翻译出错，请更新
lines 已知	翻译出错，请更新
lucky 已知	翻译出错，请更新
managed 已知	翻译出错，请更新
message 已知	翻译出错，请更新
mob 已知	翻译出错，请更新
moreover 已知	翻译出错，请更新
move 已知	翻译出错，请更新
neighbourhood 已知	翻译出错，请更新
outside 已知	翻译出错，请更新
owner 已知	翻译出错，请更新
paternal 已知	翻译出错，请更新
penny 已知	翻译出错，请更新
pleases 已知	翻译出错，请更新
pledge 已知	翻译出错，请更新
practice 已知	翻译出错，请更新
preferred 已知	翻译出错，请更新
properly 已知	翻译出错，请更新
rarely 已知	翻译出错，请更新
reconciliation 已知	翻译出错，请更新
resolve 已知	翻译出错，请更新
reward 已知	翻译出错，请更新
row 已知	翻译出错，请更新
rumour 已知	翻译出错，请更新
rush 已知	翻译出错，请更新
sacrifice 已知	翻译出错，请更新
saved 已知	翻译出错，请更新
scorn 已知	翻译出错，请更新
sheep 已知	翻译出错，请更新
simple 已知	翻译出错，请更新
stayed 已知	翻译出错，请更新
strike 已知	翻译出错，请更新
suitor 已知	翻译出错，请更新
tale 已知	翻译出错，请更新
theory 已知	翻译出错，请更新
thick 已知	翻译出错，请更新
throughout 已知	翻译出错，请更新
treat 已知	翻译出错，请更新
truly 已知	翻译出错，请更新
uncomfortable 已知	翻译出错，请更新
unkind 已知	翻译出错，请更新
value 已知	翻译出错，请更新
vanity 已知	翻译出错，请更新
ventured 已知	翻译出错，请更新
wanting 已知	翻译出错，请更新
weary 已知	翻译出错，请更新
wide 已知	翻译出错，请更新
wifes 已知	翻译出错，请更新
wine 已知	翻译出错，请更新
wore 已知	翻译出错，请更新
Am 已知	翻译出错，请更新
Baddingham 已知	翻译出错，请更新
Church 已知	翻译出错，请更新
Clare 已知	翻译出错，请更新
Colepepper 已知	翻译出错，请更新
Daubenys 已知	翻译出错，请更新
Everything 已知	翻译出错，请更新
Exactly 已知	翻译出错，请更新
Graces 已知	翻译出错，请更新
Irishman 已知	翻译出错，请更新
None 已知	翻译出错，请更新
Shortribs 已知	翻译出错，请更新
Sundays 已知	翻译出错，请更新
Whats 已知	翻译出错，请更新
absolute 已知	翻译出错，请更新
agony 已知	翻译出错，请更新
allusion 已知	翻译出错，请更新
aloof 已知	翻译出错，请更新
amidst 已知	翻译出错，请更新
apt 已知	翻译出错，请更新
army 已知	翻译出错，请更新
awe 已知	翻译出错，请更新
bell 已知	翻译出错，请更新
blessed 已知	翻译出错，请更新
bought 已知	翻译出错，请更新
bow 已知	翻译出错，请更新
calls 已知	翻译出错，请更新
carrying 已知	翻译出错，请更新
chairs 已知	翻译出错，请更新
chances 已知	翻译出错，请更新
changing 已知	翻译出错，请更新
cheered 已知	翻译出错，请更新
chief 已知	翻译出错，请更新
claim 已知	翻译出错，请更新
conceived 已知	翻译出错，请更新
condescended 已知	翻译出错，请更新
congratulate 已知	翻译出错，请更新
consolation 已知	翻译出错，请更新
continue 已知	翻译出错，请更新
convinced 已知	翻译出错，请更新
courteous 已知	翻译出错，请更新
created 已知	翻译出错，请更新
debts 已知	翻译出错，请更新
declined 已知	翻译出错，请更新
deep 已知	翻译出错，请更新
devoted 已知	翻译出错，请更新
dingy 已知	翻译出错，请更新
dishonest 已知	翻译出错，请更新
dissolve 已知	翻译出错，请更新
distant 已知	翻译出错，请更新
disturbed 已知	翻译出错，请更新
doors 已知	翻译出错，请更新
doubtless 已知	毫无疑问
dragon 已知	翻译出错，请更新
elected 已知	翻译出错，请更新
empty 已知	翻译出错，请更新
enemy 已知	翻译出错，请更新
entrance 已知	翻译出错，请更新
envy 已知	翻译出错，请更新
event 已知	翻译出错，请更新
exercise 已知	翻译出错，请更新
extent 已知	翻译出错，请更新
female 已知	翻译出错，请更新
fill 已知	翻译出错，请更新
finished 已知	翻译出错，请更新
foreign 已知	翻译出错，请更新
formed 已知	翻译出错，请更新
fully 已知	翻译出错，请更新
gangway 已知	翻译出错，请更新
garrotted 已知	翻译出错，请更新
gout 已知	翻译出错，请更新
gratitude 已知	翻译出错，请更新
grounds 已知	翻译出错，请更新
hang 已知	翻译出错，请更新
happen 已知	翻译出错，请更新
hearts 已知	翻译出错，请更新
hed 已知	翻译出错，请更新
hesitated 已知	翻译出错，请更新
hit 已知	翻译出错，请更新
hunt 已知	翻译出错，请更新
indifference 已知	翻译出错，请更新
injure 已知	翻译出错，请更新
instant 已知	翻译出错，请更新
interruption 已知	翻译出错，请更新
joke 已知	翻译出错，请更新
justified 已知	翻译出错，请更新
kissed 已知	翻译出错，请更新
knocked 已知	翻译出错，请更新
larger 已知	翻译出错，请更新
lawn 已知	翻译出错，请更新
lead 已知	翻译出错，请更新
leaders 已知	翻译出错，请更新
learning 已知	翻译出错，请更新
lesson 已知	翻译出错，请更新
liberty 已知	翻译出错，请更新
lie 已知	翻译出错，请更新
liking 已知	翻译出错，请更新
listening 已知	翻译出错，请更新
loss 已知	翻译出错，请更新
maid 已知	翻译出错，请更新
milk 已知	翻译出错，请更新
minister 已知	部长大臣
nearest 已知	翻译出错，请更新
needed 已知	翻译出错，请更新
noble 已知	翻译出错，请更新
oblige 已知	翻译出错，请更新
occupation 已知	翻译出错，请更新
occupied 已知	翻译出错，请更新
odious 已知	翻译出错，请更新
offices 已知	翻译出错，请更新
older 已知	翻译出错，请更新
opponents 已知	翻译出错，请更新
orator 已知	翻译出错，请更新
owe 已知	翻译出错，请更新
owned 已知	翻译出错，请更新
pain 已知	翻译出错，请更新
pardon 已知	翻译出错，请更新
patient 已知	翻译出错，请更新
paying 已知	翻译出错，请更新
pen 已知	翻译出错，请更新
petition 已知	翻译出错，请更新
pleasures 已知	翻译出错，请更新
politicians 已知	翻译出错，请更新
possession 已知	翻译出错，请更新
postponed 已知	翻译出错，请更新
praise 已知	翻译出错，请更新
prayers 已知	翻译出错，请更新
previous 已知	翻译出错，请更新
railway 已知	铁路
receiving 已知	翻译出错，请更新
regretted 已知	翻译出错，请更新
rejected 已知	翻译出错，请更新
relief 已知	翻译出错，请更新
removed 已知	翻译出错，请更新
report 已知	翻译出错，请更新
respects 已知	翻译出错，请更新
selected 已知	翻译出错，请更新
served 已知	翻译出错，请更新
shooting 已知	翻译出错，请更新
square 已知	正方形场
stoutly 已知	翻译出错，请更新
straight 已知	翻译出错，请更新
submit 已知	翻译出错，请更新
suited 已知	翻译出错，请更新
sun 已知	翻译出错，请更新
sundry 已知	翻译出错，请更新
takes 已知	翻译出错，请更新
tenderness 已知	翻译出错，请更新
terribly 已知	翻译出错，请更新
thorough 已知	翻译出错，请更新
trap 已知	翻译出错，请更新
troubled 已知	翻译出错，请更新
troubles 已知	麻烦
unfit 已知	翻译出错，请更新
usually 已知	翻译出错，请更新
visitors 已知	翻译出错，请更新
voted 已知	翻译出错，请更新
wages 已知	翻译出错，请更新
wandered 已知	翻译出错，请更新
warmly 已知	翻译出错，请更新
wasnt 已知	翻译出错，请更新
wind 已知	翻译出错，请更新
withdraw 已知	翻译出错，请更新
youd 已知	翻译出错，请更新
Address 已知	翻译出错，请更新
Belgium 已知	翻译出错，请更新
Berkeley 已知	翻译出错，请更新
Castle 已知	翻译出错，请更新
Castlemorris 已知	翻译出错，请更新
December 已知	翻译出错，请更新
Grating 已知	翻译出错，请更新
Hartletop 已知	翻译出错，请更新
Hell 已知	翻译出错，请更新
However 已知	翻译出错，请更新
June 已知	翻译出错，请更新
Marys 已知	翻译出错，请更新
Morecombe 已知	翻译出错，请更新
November 已知	翻译出错，请更新
Old 已知	翻译出错，请更新
Pall 已知	翻译出错，请更新
Psha 已知	翻译出错，请更新
Silverbridge 已知	翻译出错，请更新
Theres 已知	翻译出错，请更新
abroad 已知	翻译出错，请更新
absent 已知	翻译出错，请更新
accepting 已知	翻译出错，请更新
acquainted 已知	翻译出错，请更新
admiration 已知	翻译出错，请更新
allowance 已知	翻译出错，请更新
apart 已知	翻译出错，请更新
apparently 已知	翻译出错，请更新
appear 已知	翻译出错，请更新
approach 已知	翻译出错，请更新
arrange 已知	翻译出错，请更新
asks 已知	翻译出错，请更新
assumed 已知	翻译出错，请更新
attend 已知	翻译出错，请更新
aught 已知	翻译出错，请更新
august 已知	翻译出错，请更新
avoided 已知	翻译出错，请更新
awhile 已知	翻译出错，请更新
begged 已知	翻译出错，请更新
bidding 已知	翻译出错，请更新
birds 已知	翻译出错，请更新
boast 已知	翻译出错，请更新
bones 已知	翻译出错，请更新
bridge 已知	翻译出错，请更新
calling 已知	翻译出错，请更新
candidates 已知	翻译出错，请更新
catch 已知	翻译出错，请更新
changes 已知	翻译出错，请更新
chimney 已知	翻译出错，请更新
commenced 已知	翻译出错，请更新
compatible 已知	翻译出错，请更新
conceive 已知	翻译出错，请更新
concern 已知	翻译出错，请更新
contest 已知	翻译出错，请更新
cross 已知	交叉
crossed 已知	翻译出错，请更新
cured 已知	翻译出错，请更新
debating 已知	翻译出错，请更新
delay 已知	翻译出错，请更新
desirous 已知	翻译出错，请更新
discussing 已知	翻译出错，请更新
divided 已知	翻译出错，请更新
drank 已知	翻译出错，请更新
drawn 已知	翻译出错，请更新
dream 已知	翻译出错，请更新
dressed 已知	翻译出错，请更新
drunk 已知	翻译出错，请更新
duchess 已知	翻译出错，请更新
duties 已知	翻译出错，请更新
efforts 已知	翻译出错，请更新
elections 已知	翻译出错，请更新
elsewhere 已知	翻译出错，请更新
enjoy 已知	翻译出错，请更新
entire 已知	翻译出错，请更新
esteem 已知	翻译出错，请更新
expressing 已知	翻译出错，请更新
facts 已知	翻译出错，请更新
farewell 已知	翻译出错，请更新
finds 已知	翻译出错，请更新
fresh 已知	翻译出错，请更新
gentle 已知	翻译出错，请更新
gents 已知	翻译出错，请更新
god 已知	翻译出错，请更新
goodbye 已知	翻译出错，请更新
granted 已知	翻译出错，请更新
grapes 已知	翻译出错，请更新
gratification 已知	翻译出错，请更新
grief 已知	翻译出错，请更新
grow 已知	翻译出错，请更新
grown 已知	翻译出错，请更新
gun 已知	翻译出错，请更新
hating 已知	翻译出错，请更新
heaven 已知	翻译出错，请更新
honesty 已知	翻译出错，请更新
hoping 已知	翻译出错，请更新
humble 已知	翻译出错，请更新
idleness 已知	翻译出错，请更新
increased 已知	翻译出错，请更新
incumbent 已知	翻译出错，请更新
indiscreet 已知	翻译出错，请更新
insult 已知	翻译出错，请更新
intercourse 已知	翻译出错，请更新
keen 已知	翻译出错，请更新
leaning 已知	翻译出错，请更新
lies 已知	翻译出错，请更新
losing 已知	翻译出错，请更新
lunch 已知	翻译出错，请更新
magistrates 已知	翻译出错，请更新
mark 已知	翻译出错，请更新
meetings 已知	翻译出错，请更新
messenger 已知	翻译出错，请更新
minded 已知	翻译出错，请更新
ministerial 已知	翻译出错，请更新
ministry 已知	翻译出错，请更新
miserable 已知	翻译出错，请更新
newspapers 已知	翻译出错，请更新
novel 已知	翻译出错，请更新
observed 已知	翻译出错，请更新
obtained 已知	翻译出错，请更新
occasionally 已知	翻译出错，请更新
openly 已知	翻译出错，请更新
painted 已知	翻译出错，请更新
parts 已知	翻译出错，请更新
passage 已知	翻译出错，请更新
performance 已知	翻译出错，请更新
persuade 已知	翻译出错，请更新
petted 已知	翻译出错，请更新
pieces 已知	翻译出错，请更新
positively 已知	翻译出错，请更新
powerful 已知	翻译出错，请更新
precious 已知	翻译出错，请更新
preparing 已知	翻译出错，请更新
pressing 已知	翻译出错，请更新
pull 已知	翻译出错，请更新
purposes 已知	翻译出错，请更新
recommend 已知	翻译出错，请更新
regards 已知	翻译出错，请更新
remaining 已知	翻译出错，请更新
representation 已知	翻译出错，请更新
residence 已知	翻译出错，请更新
retreated 已知	翻译出错，请更新
rise 已知	翻译出错，请更新
rushed 已知	翻译出错，请更新
s 已知	翻译出错，请更新
sang 已知	翻译出错，请更新
share 已知	翻译出错，请更新
skill 已知	翻译出错，请更新
sorely 已知	翻译出错，请更新
strange 已知	翻译出错，请更新
struck 已知	翻译出错，请更新
studied 已知	翻译出错，请更新
successes 已知	翻译出错，请更新
suddenly 已知	翻译出错，请更新
suggested 已知	翻译出错，请更新
supported 已知	翻译出错，请更新
swan 已知	翻译出错，请更新
sweetest 已知	翻译出错，请更新
talks 已知	翻译出错，请更新
telegram 已知	翻译出错，请更新
thence 已知	翻译出错，请更新
theyll 已知	他们会
throwing 已知	翻译出错，请更新
title 已知	翻译出错，请更新
treachery 已知	翻译出错，请更新
unfortunately 已知	翻译出错，请更新
union 已知	翻译出错，请更新
unjust 已知	翻译出错，请更新
utterly 已知	翻译出错，请更新
view 已知	翻译出错，请更新
war 已知	翻译出错，请更新
warm 已知	翻译出错，请更新
warned 已知	翻译出错，请更新
watch 已知	翻译出错，请更新
wicked 已知	翻译出错，请更新
willingly 已知	翻译出错，请更新
windows 已知	翻译出错，请更新
yield 已知	翻译出错，请更新
Admiralty 已知	翻译出错，请更新
Board 已知	翻译出错，请更新
Brighton 已知	翻译出错，请更新
Como 已知	翻译出错，请更新
Englishmen 已知	翻译出错，请更新
Glencoras 已知	翻译出错，请更新
Grey 已知	翻译出错，请更新
Having 已知	翻译出错，请更新
Houses 已知	翻译出错，请更新
Immediately 已知	翻译出错，请更新
Jacob 已知	翻译出错，请更新
Liberals 已知	翻译出错，请更新
Linn 已知	翻译出错，请更新
Oxford 已知	翻译出错，请更新
Quite 已知	翻译出错，请更新
Right 已知	翻译出错，请更新
Robson 已知	翻译出错，请更新
Roby 已知	翻译出错，请更新
Speakers 已知	翻译出错，请更新
Those 已知	翻译出错，请更新
Vienna 已知	翻译出错，请更新
acting 已知	翻译出错，请更新
added 已知	翻译出错，请更新
advocate 已知	翻译出错，请更新
alternative 已知	翻译出错，请更新
amiss 已知	翻译出错，请更新
answering 已知	翻译出错，请更新
anywhere 已知	翻译出错，请更新
ardent 已知	翻译出错，请更新
assembly 已知	翻译出错，请更新
audience 已知	翻译出错，请更新
authority 已知	翻译出错，请更新
ball 已知	翻译出错，请更新
barely 已知	翻译出错，请更新
beast 已知	翻译出错，请更新
belonging 已知	翻译出错，请更新
bless 已知	翻译出错，请更新
bottom 已知	翻译出错，请更新
brain 已知	翻译出错，请更新
brandy 已知	翻译出错，请更新
breaking 已知	翻译出错，请更新
breath 已知	翻译出错，请更新
bride 已知	翻译出错，请更新
broad 已知	翻译出错，请更新
brougham 已知	翻译出错，请更新
carefully 已知	翻译出错，请更新
cares 已知	翻译出错，请更新
castle 已知	翻译出错，请更新
ceased 已知	翻译出错，请更新
certainty 已知	翻译出错，请更新
chapter 已知	章节篇章
class 已知	翻译出错，请更新
clerk 已知	翻译出错，请更新
comply 已知	翻译出错，请更新
condescend 已知	翻译出错，请更新
condition 已知	翻译出错，请更新
confessed 已知	翻译出错，请更新
confined 已知	翻译出错，请更新
consequence 已知	翻译出错，请更新
constantly 已知	翻译出错，请更新
content 已知	翻译出错，请更新
court 已知	翻译出错，请更新
create 已知	翻译出错，请更新
debates 已知	翻译出错，请更新
defend 已知	翻译出错，请更新
depend 已知	翻译出错，请更新
dependent 已知	翻译出错，请更新
despised 已知	翻译出错，请更新
directly 已知	翻译出错，请更新
disappointment 已知	翻译出错，请更新
disgraced 已知	翻译出错，请更新
dissolution 已知	翻译出错，请更新
disturb 已知	翻译出错，请更新
doesnt 已知	翻译出错，请更新
dreadful 已知	翻译出错，请更新
earnestness 已知	翻译出错，请更新
earning 已知	翻译出错，请更新
easier 已知	翻译出错，请更新
elder 已知	翻译出错，请更新
eloquent 已知	翻译出错，请更新
encounter 已知	翻译出错，请更新
endeavouring 已知	翻译出错，请更新
enjoyed 已知	翻译出错，请更新
entertained 已知	翻译出错，请更新
everywhere 已知	翻译出错，请更新
evidently 已知	翻译出错，请更新
existing 已知	翻译出错，请更新
faces 已知	翻译出错，请更新
familiar 已知	翻译出错，请更新
fatal 已知	翻译出错，请更新
feels 已知	翻译出错，请更新
flavour 已知	翻译出错，请更新
forgiven 已知	翻译出错，请更新
gallantly 已知	翻译出错，请更新
gorgeous 已知	翻译出错，请更新
grave 已知	翻译出错，请更新
growing 已知	翻译出错，请更新
guilty 已知	翻译出错，请更新
heavens 已知	翻译出错，请更新
hesitation 已知	翻译出错，请更新
highest 已知	翻译出错，请更新
highly 已知	翻译出错，请更新
hinted 已知	翻译出错，请更新
honestly 已知	翻译出错，请更新
horrible 已知	翻译出错，请更新
hundreds 已知	翻译出错，请更新
hunts 已知	翻译出错，请更新
hurried 已知	翻译出错，请更新
ignorance 已知	翻译出错，请更新
illnatured 已知	翻译出错，请更新
impetuous 已知	翻译出错，请更新
improbable 已知	翻译出错，请更新
imprudent 已知	翻译出错，请更新
indicated 已知	翻译出错，请更新
interested 已知	翻译出错，请更新
justice 已知	翻译出错，请更新
kick 已知	翻译出错，请更新
kindly 已知	翻译出错，请更新
kindness 已知	翻译出错，请更新
lack 已知	翻译出错，请更新
ladder 已知	翻译出错，请更新
landlord 已知	翻译出错，请更新
lawyer 已知	翻译出错，请更新
lend 已知	翻译出错，请更新
lock 已知	翻译出错，请更新
lying 已知	翻译出错，请更新
magistrate 已知	翻译出错，请更新
maiden 已知	翻译出错，请更新
manifestly 已知	翻译出错，请更新
match 已知	翻译出错，请更新
mere 已知	翻译出错，请更新
merit 已知	翻译出错，请更新
midst 已知	翻译出错，请更新
missed 已知	翻译出错，请更新
movement 已知	翻译出错，请更新
nation 已知	翻译出错，请更新
newspaper 已知	翻译出错，请更新
obey 已知	翻译出错，请更新
obtain 已知	翻译出错，请更新
oppose 已知	翻译出错，请更新
passages 已知	翻译出错，请更新
peculiar 已知	翻译出错，请更新
played 已知	翻译出错，请更新
pledged 已知	翻译出错，请更新
pointing 已知	翻译出错，请更新
positive 已知	翻译出错，请更新
post 已知	翻译出错，请更新
powers 已知	翻译出错，请更新
pray 已知	翻译出错，请更新
prevail 已知	翻译出错，请更新
principle 已知	翻译出错，请更新
prize 已知	翻译出错，请更新
prove 已知	翻译出错，请更新
pushed 已知	翻译出错，请更新
quietly 已知	翻译出错，请更新
raise 已知	翻译出错，请更新
raised 已知	翻译出错，请更新
raising 已知	翻译出错，请更新
recommended 已知	翻译出错，请更新
reformer 已知	翻译出错，请更新
refusal 已知	翻译出错，请更新
regrets 已知	翻译出错，请更新
remainder 已知	翻译出错，请更新
remembering 已知	翻译出错，请更新
responsibility 已知	翻译出错，请更新
retreat 已知	翻译出错，请更新
rocks 已知	翻译出错，请更新
rule 已知	翻译出错，请更新
rules 已知	翻译出错，请更新
sands 已知	翻译出错，请更新
secure 已知	翻译出错，请更新
seek 已知	翻译出错，请更新
shaking 已知	翻译出错，请更新
shame 已知	翻译出错，请更新
sides 已知	翻译出错，请更新
skin 已知	翻译出错，请更新
speaker 已知	翻译出错，请更新
stomach 已知	翻译出错，请更新
stone 已知	翻译出错，请更新
stop 已知	翻译出错，请更新
stranger 已知	翻译出错，请更新
strangers 已知	翻译出错，请更新
stuck 已知	翻译出错，请更新
subsequent 已知	翻译出错，请更新
suffer 已知	翻译出错，请更新
summoned 已知	翻译出错，请更新
suspected 已知	翻译出错，请更新
system 已知	翻译出错，请更新
tea 已知	翻译出错，请更新
teach 已知	翻译出错，请更新
thanked 已知	翻译出错，请更新
trial 已知	翻译出错，请更新
triumphant 已知	翻译出错，请更新
trusted 已知	翻译出错，请更新
turf 已知	翻译出错，请更新
utter 已知	翻译出错，请更新
vacant 已知	翻译出错，请更新
villa 已知	翻译出错，请更新
voices 已知	翻译出错，请更新
waters 已知	翻译出错，请更新
weakness 已知	翻译出错，请更新
wishing 已知	翻译出错，请更新
worship 已知	翻译出错，请更新
wounded 已知	翻译出错，请更新
According 已知	翻译出错，请更新
Aspasia 已知	翻译出错，请更新
Bedad 已知	翻译出错，请更新
Besides 已知	翻译出错，请更新
Cabinets 已知	翻译出错，请更新
Callender 已知	翻译出错，请更新
Canada 已知	翻译出错，请更新
Constitution 已知	翻译出错，请更新
County 已知	翻译出错，请更新
Court 已知	翻译出错，请更新
Donald 已知	翻译出错，请更新
Erles 已知	翻译出错，请更新
Exchequer 已知	翻译出错，请更新
Fothergill 已知	翻译出错，请更新
G 已知	翻译出错，请更新
Green 已知	翻译出错，请更新
Italian 已知	翻译出错，请更新
M 已知	翻译出错，请更新
Majestys 已知	翻译出错，请更新
Mall 已知	翻译出错，请更新
Much 已知	翻译出错，请更新
Ostend 已知	翻译出错，请更新
Oswalds 已知	翻译出错，请更新
Ouse 已知	翻译出错，请更新
Phoebus 已知	翻译出错，请更新
Plinlimmon 已知	翻译出错，请更新
Remember 已知	翻译出错，请更新
Roman 已知	翻译出错，请更新
Speak 已知	翻译出错，请更新
States 已知	翻译出错，请更新
Trade 已知	翻译出错，请更新
Youre 已知	翻译出错，请更新
abuse 已知	翻译出错，请更新
accuracy 已知	翻译出错，请更新
accusing 已知	翻译出错，请更新
active 已知	翻译出错，请更新
adjourned 已知	翻译出错，请更新
admire 已知	翻译出错，请更新
advising 已知	翻译出错，请更新
alas 已知	翻译出错，请更新
alluded 已知	翻译出错，请更新
alluring 已知	翻译出错，请更新
ally 已知	翻译出错，请更新
amusement 已知	翻译出错，请更新
approaching 已知	翻译出错，请更新
argue 已知	翻译出错，请更新
arminarm 已知	翻译出错，请更新
arranging 已知	翻译出错，请更新
aspirations 已知	翻译出错，请更新
assertion 已知	翻译出错，请更新
attempting 已知	翻译出错，请更新
avail 已知	翻译出错，请更新
baby 已知	翻译出错，请更新
beat 已知	翻译出错，请更新
beautifully 已知	翻译出错，请更新
begins 已知	翻译出错，请更新
believing 已知	翻译出错，请更新
belong 已知	翻译出错，请更新
beside 已知	翻译出错，请更新
besides 已知	翻译出错，请更新
bet 已知	翻译出错，请更新
birth 已知	翻译出错，请更新
blame 已知	翻译出错，请更新
blind 已知	翻译出错，请更新
blushing 已知	翻译出错，请更新
bowed 已知	翻译出错，请更新
budget 已知	翻译出错，请更新
built 已知	翻译出错，请更新
cheat 已知	翻译出错，请更新
chooses 已知	翻译出错，请更新
clauses 已知	翻译出错，请更新
clenched 已知	翻译出错，请更新
colleague 已知	翻译出错，请更新
collected 已知	翻译出错，请更新
columns 已知	翻译出错，请更新
comfortably 已知	翻译出错，请更新
compact 已知	翻译出错，请更新
companions 已知	翻译出错，请更新
complexion 已知	翻译出错，请更新
conference 已知	翻译出错，请更新
consequences 已知	翻译出错，请更新
counsels 已知	翻译出错，请更新
countesses 已知	翻译出错，请更新
countrymen 已知	翻译出错，请更新
coward 已知	翻译出错，请更新
cravat 已知	翻译出错，请更新
cunning 已知	翻译出错，请更新
cure 已知	翻译出错，请更新
degrade 已知	翻译出错，请更新
describe 已知	翻译出错，请更新
deserted 已知	翻译出错，请更新
deserved 已知	翻译出错，请更新
desires 已知	翻译出错，请更新
deuce 已知	翻译出错，请更新
dim 已知	翻译出错，请更新
discussions 已知	翻译出错，请更新
disgust 已知	翻译出错，请更新
disliked 已知	翻译出错，请更新
double 已知	翻译出错，请更新
doubting 已知	翻译出错，请更新
downright 已知	翻译出错，请更新
dread 已知	翻译出错，请更新
dreary 已知	翻译出错，请更新
dukes 已知	翻译出错，请更新
dust 已知	翻译出错，请更新
eaten 已知	翻译出错，请更新
effectually 已知	翻译出错，请更新
electoral 已知	翻译出错，请更新
employed 已知	翻译出错，请更新
enable 已知	翻译出错，请更新
enabled 已知	翻译出错，请更新
encouraged 已知	翻译出错，请更新
encouragement 已知	翻译出错，请更新
enjoyment 已知	翻译出错，请更新
entitled 已知	翻译出错，请更新
escaped 已知	翻译出错，请更新
established 已知	翻译出错，请更新
evenings 已知	翻译出错，请更新
exact 已知	翻译出错，请更新
excellence 已知	翻译出错，请更新
exclaimed 已知	翻译出错，请更新
expediency 已知	翻译出错，请更新
explaining 已知	翻译出错，请更新
fairly 已知	翻译出错，请更新
falling 已知	翻译出错，请更新
falls 已知	翻译出错，请更新
farmer 已知	翻译出错，请更新
favoured 已知	翻译出错，请更新
fence 已知	翻译出错，请更新
ferocity 已知	翻译出错，请更新
field 已知	翻译出错，请更新
figure 已知	翻译出错，请更新
flattered 已知	翻译出错，请更新
fortunate 已知	翻译出错，请更新
fun 已知	翻译出错，请更新
furniture 已知	翻译出错，请更新
gallant 已知	翻译出错，请更新
gathered 已知	翻译出错，请更新
gentlemans 已知	翻译出错，请更新
glance 已知	翻译出错，请更新
gloomy 已知	翻译出错，请更新
glorious 已知	翻译出错，请更新
gloves 已知	翻译出错，请更新
governing 已知	翻译出错，请更新
greet 已知	翻译出错，请更新
grew 已知	翻译出错，请更新
guided 已知	翻译出错，请更新
habits 已知	翻译出错，请更新
happiest 已知	翻译出错，请更新
harness 已知	翻译出错，请更新
harsh 已知	翻译出错，请更新
heads 已知	翻译出错，请更新
heiress 已知	翻译出错，请更新
horseback 已知	翻译出错，请更新
hostess 已知	翻译出错，请更新
hostile 已知	翻译出错，请更新
household 已知	翻译出错，请更新
illused 已知	翻译出错，请更新
immediate 已知	翻译出错，请更新
imperative 已知	翻译出错，请更新
impression 已知	翻译出错，请更新
injustice 已知	翻译出错，请更新
instincts 已知	翻译出错，请更新
intellect 已知	翻译出错，请更新
interesting 已知	翻译出错，请更新
introduce 已知	翻译出错，请更新
judges 已知	翻译出错，请更新
lacked 已知	翻译出错，请更新
leads 已知	翻译出错，请更新
leaves 已知	翻译出错，请更新
lodger 已知	翻译出错，请更新
longing 已知	翻译出错，请更新
mad 已知	翻译出错，请更新
management 已知	翻译出错，请更新
manly 已知	翻译出错，请更新
manners 已知	翻译出错，请更新
mild 已知	翻译出错，请更新
miss 已知	翻译出错，请更新
mistaken 已知	翻译出错，请更新
modes 已知	翻译出错，请更新
morsel 已知	翻译出错，请更新
mounted 已知	翻译出错，请更新
moving 已知	翻译出错，请更新
mud 已知	翻译出错，请更新
naturally 已知	翻译出错，请更新
nay 已知	翻译出错，请更新
neighbour 已知	翻译出错，请更新
nodded 已知	翻译出错，请更新
nuisance 已知	翻译出错，请更新
numerous 已知	翻译出错，请更新
objectionable 已知	翻译出错，请更新
occupy 已知	翻译出错，请更新
orders 已知	翻译出错，请更新
painful 已知	翻译出错，请更新
patience 已知	翻译出错，请更新
patronage 已知	赞助
payment 已知	翻译出错，请更新
permanent 已知	翻译出错，请更新
permitted 已知	翻译出错，请更新
persevere 已知	翻译出错，请更新
photograph 已知	翻译出错，请更新
picture 已知	翻译出错，请更新
plea 已知	翻译出错，请更新
pleaded 已知	翻译出错，请更新
pleasantly 已知	翻译出错，请更新
policemen 已知	翻译出错，请更新
possibility 已知	翻译出错，请更新
practised 已知	翻译出错，请更新
prestige 已知	翻译出错，请更新
presume 已知	翻译出错，请更新
pretence 已知	翻译出错，请更新
prey 已知	翻译出错，请更新
printed 已知	翻译出错，请更新
programme 已知	翻译出错，请更新
proved 已知	翻译出错，请更新
puts 已知	翻译出错，请更新
rang 已知	翻译出错，请更新
readily 已知	翻译出错，请更新
reality 已知	翻译出错，请更新
redistribution 已知	再分配
reflect 已知	翻译出错，请更新
relations 已知	翻译出错，请更新
remarks 已知	翻译出错，请更新
remembrance 已知	翻译出错，请更新
reported 已知	翻译出错，请更新
reproach 已知	翻译出错，请更新
resigning 已知	翻译出错，请更新
rob 已知	翻译出错，请更新
rock 已知	翻译出错，请更新
rumours 已知	翻译出错，请更新
sacrificed 已知	翻译出错，请更新
safety 已知	翻译出错，请更新
satisfy 已知	翻译出错，请更新
saving 已知	翻译出错，请更新
scores 已知	翻译出错，请更新
scruple 已知	翻译出错，请更新
search 已知	翻译出错，请更新
secrets 已知	翻译出错，请更新
sending 已知	翻译出错，请更新
separate 已知	翻译出错，请更新
separated 已知	翻译出错，请更新
sergeant 已知	翻译出错，请更新
sermon 已知	翻译出错，请更新
sex 已知	翻译出错，请更新
shadow 已知	翻译出错，请更新
sharply 已知	翻译出错，请更新
sherry 已知	翻译出错，请更新
shipwreck 已知	翻译出错，请更新
sign 已知	翻译出错，请更新
silly 已知	翻译出错，请更新
sincerely 已知	翻译出错，请更新
slavery 已知	翻译出错，请更新
solemn 已知	翻译出错，请更新
solitary 已知	翻译出错，请更新
song 已知	翻译出错，请更新
source 已知	翻译出错，请更新
spending 已知	翻译出错，请更新
spur 已知	翻译出错，请更新
stern 已知	翻译出错，请更新
stopping 已知	翻译出错，请更新
straw 已知	翻译出错，请更新
struggle 已知	翻译出错，请更新
stump 已知	翻译出错，请更新
successfully 已知	翻译出错，请更新
suffered 已知	翻译出错，请更新
suffrage 已知	翻译出错，请更新
suspicion 已知	翻译出错，请更新
swerve 已知	翻译出错，请更新
tall 已知	翻译出错，请更新
teaching 已知	翻译出错，请更新
tempted 已知	翻译出错，请更新
tenant 已知	翻译出错，请更新
tender 已知	翻译出错，请更新
thank 已知	翻译出错，请更新
theyre 已知	他们是
thousands 已知	翻译出错，请更新
threatened 已知	翻译出错，请更新
trees 已知	翻译出错，请更新
trifle 已知	翻译出错，请更新
twentyfive 已知	翻译出错，请更新
uncertain 已知	翻译出错，请更新
uneasy 已知	翻译出错，请更新
ungrateful 已知	翻译出错，请更新
unlimited 已知	翻译出错，请更新
unreasonable 已知	翻译出错，请更新
until 已知	翻译出错，请更新
unwilling 已知	翻译出错，请更新
unworthy 已知	翻译出错，请更新
upright 已知	翻译出错，请更新
vengeance 已知	翻译出错，请更新
victory 已知	翻译出错，请更新
violently 已知	翻译出错，请更新
voting 已知	翻译出错，请更新
waited 已知	翻译出错，请更新
watched 已知	翻译出错，请更新
wearing 已知	翻译出错，请更新
whats 已知	翻译出错，请更新
wives 已知	翻译出错，请更新
writer 已知	翻译出错，请更新
ye 已知	翻译出错，请更新
younger 已知	翻译出错，请更新
Ben 已知	翻译出错，请更新
Bodkin 已知	翻译出错，请更新
Bohemian 已知	翻译出错，请更新
Callaghan 已知	翻译出错，请更新
Charles 已知	翻译出错，请更新
Christian 已知	翻译出错，请更新
Clutterbuck 已知	翻译出错，请更新
Colonies 已知	翻译出错，请更新
Early 已知	翻译出错，请更新
Europe 已知	翻译出错，请更新
Foreign 已知	翻译出错，请更新
Galway 已知	翻译出错，请更新
Glasgow 已知	翻译出错，请更新
Heaven 已知	翻译出错，请更新
Holstein 已知	翻译出错，请更新
Home 已知	翻译出错，请更新
Jack 已知	翻译出错，请更新
Labour 已知	翻译出错，请更新
Lancaster 已知	翻译出错，请更新
Marylebone 已知	翻译出错，请更新
Mentor 已知	翻译出错，请更新
Might 已知	翻译出错，请更新
Moody 已知	翻译出错，请更新
Neither 已知	翻译出错，请更新
Nobody 已知	翻译出错，请更新
October 已知	翻译出错，请更新
Once 已知	翻译出错，请更新
PHINEAS 已知	翻译出错，请更新
Palace 已知	翻译出错，请更新
Parliamentary 已知	翻译出错，请更新
Piles 已知	翻译出错，请更新
Powell 已知	翻译出错，请更新
Premier 已知	翻译出错，请更新
President 已知	翻译出错，请更新
Rome 已知	翻译出错，请更新
Slides 已知	翻译出错，请更新
Something 已知	翻译出错，请更新
Suppose 已知	翻译出错，请更新
Telemachus 已知	翻译出错，请更新
Thus 已知	翻译出错，请更新
Vellum 已知	翻译出错，请更新
Whigs 已知	翻译出错，请更新
While 已知	翻译出错，请更新
Women 已知	翻译出错，请更新
Yard 已知	翻译出错，请更新
abrupt 已知	翻译出错，请更新
accidents 已知	翻译出错，请更新
accounts 已知	翻译出错，请更新
admired 已知	翻译出错，请更新
adopt 已知	翻译出错，请更新
advantages 已知	翻译出错，请更新
adventure 已知	翻译出错，请更新
agent 已知	翻译出错，请更新
agreeable 已知	翻译出错，请更新
alliance 已知	翻译出错，请更新
allies 已知	翻译出错，请更新
allowing 已知	翻译出错，请更新
ancient 已知	翻译出错，请更新
animal 已知	翻译出错，请更新
apparent 已知	翻译出错，请更新
argued 已知	翻译出错，请更新
armchairs 已知	翻译出错，请更新
arose 已知	翻译出错，请更新
arrested 已知	翻译出错，请更新
assert 已知	翻译出错，请更新
astonished 已知	翻译出错，请更新
astray 已知	翻译出错，请更新
attended 已知	翻译出错，请更新
attorneys 已知	翻译出错，请更新
audacity 已知	翻译出错，请更新
bills 已知	翻译出错，请更新
bird 已知	翻译出错，请更新
bogs 已知	翻译出错，请更新
bold 已知	翻译出错，请更新
boys 已知	翻译出错，请更新
broke 已知	翻译出错，请更新
brown 已知	翻译出错，请更新
burden 已知	翻译出错，请更新
buy 已知	翻译出错，请更新
caring 已知	翻译出错，请更新
cast 已知	翻译出错，请更新
cheeks 已知	翻译出错，请更新
chiefly 已知	翻译出错，请更新
chin 已知	翻译出错，请更新
cigar 已知	翻译出错，请更新
clean 已知	翻译出错，请更新
closer 已知	翻译出错，请更新
column 已知	翻译出错，请更新
comforted 已知	翻译出错，请更新
commission 已知	翻译出错，请更新
commit 已知	翻译出错，请更新
committed 已知	翻译出错，请更新
communication 已知	翻译出错，请更新
compelled 已知	翻译出错，请更新
complete 已知	翻译出错，请更新
confided 已知	翻译出错，请更新
confine 已知	翻译出错，请更新
connected 已知	翻译出错，请更新
conquer 已知	翻译出错，请更新
conservative 已知	翻译出错，请更新
considerations 已知	翻译出错，请更新
conspicuous 已知	翻译出错，请更新
constancy 已知	翻译出错，请更新
constituencies 已知	翻译出错，请更新
constituency 已知	翻译出错，请更新
contrary 已知	翻译出错，请更新
conveyed 已知	翻译出错，请更新
count 已知	计数
cover 已知	翻译出错，请更新
croquet 已知	翻译出错，请更新
crush 已知	翻译出错，请更新
crushed 已知	翻译出错，请更新
curse 已知	翻译出错，请更新
daring 已知	翻译出错，请更新
deer 已知	翻译出错，请更新
defence 已知	翻译出错，请更新
denying 已知	翻译出错，请更新
described 已知	翻译出错，请更新
description 已知	翻译出错，请更新
desk 已知	翻译出错，请更新
desolate 已知	翻译出错，请更新
destroy 已知	翻译出错，请更新
devotion 已知	翻译出错，请更新
differently 已知	翻译出错，请更新
directed 已知	翻译出错，请更新
discomfort 已知	翻译出错，请更新
discovered 已知	翻译出错，请更新
discreet 已知	翻译出错，请更新
disgusted 已知	翻译出错，请更新
divide 已知	翻译出错，请更新
divisions 已知	翻译出错，请更新
doubtful 已知	翻译出错，请更新
downstairs 已知	翻译出错，请更新
drew 已知	翻译出错，请更新
dropped 已知	翻译出错，请更新
dry 已知	翻译出错，请更新
duels 已知	翻译出错，请更新
duly 已知	翻译出错，请更新
earlier 已知	翻译出错，请更新
eating 已知	翻译出错，请更新
editor 已知	翻译出错，请更新
endured 已知	翻译出错，请更新
energetic 已知	翻译出错，请更新
enmity 已知	翻译出错，请更新
enter 已知	翻译出错，请更新
entering 已知	翻译出错，请更新
enthusiasm 已知	翻译出错，请更新
error 已知	翻译出错，请更新
expedient 已知	翻译出错，请更新
explicit 已知	翻译出错，请更新
expressions 已知	翻译出错，请更新
extended 已知	翻译出错，请更新
faint 已知	翻译出错，请更新
falsehood 已知	翻译出错，请更新
favourable 已知	翻译出错，请更新
fears 已知	翻译出错，请更新
feminine 已知	翻译出错，请更新
fictionist 已知	翻译出错，请更新
fields 已知	翻译出错，请更新
fifteen 已知	翻译出错，请更新
finest 已知	翻译出错，请更新
fitness 已知	翻译出错，请更新
flatter 已知	翻译出错，请更新
flattering 已知	翻译出错，请更新
fleet 已知	翻译出错，请更新
flesh 已知	翻译出错，请更新
flew 已知	翻译出错，请更新
followers 已知	翻译出错，请更新
forbidden 已知	翻译出错，请更新
forehead 已知	翻译出错，请更新
freedom 已知	翻译出错，请更新
gait 已知	翻译出错，请更新
garrotters 已知	翻译出错，请更新
gaze 已知	翻译出错，请更新
gent 已知	翻译出错，请更新
glare 已知	翻译出错，请更新
glass 已知	翻译出错，请更新
goodnatured 已知	翻译出错，请更新
goodnight 已知	翻译出错，请更新
governed 已知	翻译出错，请更新
grasp 已知	翻译出错，请更新
greeted 已知	翻译出错，请更新
greeting 已知	翻译出错，请更新
grey 已知	翻译出错，请更新
group 已知	翻译出错，请更新
growth 已知	翻译出错，请更新
hadnt 已知	翻译出错，请更新
handed 已知	翻译出错，请更新
happier 已知	翻译出错，请更新
harbour 已知	翻译出错，请更新
hasnt 已知	翻译出错，请更新
hereafter 已知	翻译出错，请更新
hesitating 已知	翻译出错，请更新
hide 已知	翻译出错，请更新
honoured 已知	翻译出错，请更新
honours 已知	翻译出错，请更新
hopeless 已知	翻译出错，请更新
horgan 已知	翻译出错，请更新
horrid 已知	翻译出错，请更新
humility 已知	翻译出错，请更新
imagined 已知	翻译出错，请更新
impatient 已知	翻译出错，请更新
impediment 已知	翻译出错，请更新
increase 已知	翻译出错，请更新
indicate 已知	翻译出错，请更新
individual 已知	翻译出错，请更新
induced 已知	翻译出错，请更新
infinitely 已知	翻译出错，请更新
intent 已知	翻译出错，请更新
interference 已知	翻译出错，请更新
interfering 已知	翻译出错，请更新
iron 已知	翻译出错，请更新
jealousy 已知	翻译出错，请更新
keenly 已知	翻译出错，请更新
lasted 已知	翻译出错，请更新
legal 已知	翻译出错，请更新
legislation 已知	翻译出错，请更新
leisure 已知	翻译出错，请更新
lied 已知	翻译出错，请更新
lobbies 已知	翻译出错，请更新
lovely 已知	翻译出错，请更新
lower 已知	翻译出错，请更新
lowest 已知	翻译出错，请更新
maidservant 已知	翻译出错，请更新
maintained 已知	翻译出错，请更新
male 已知	翻译出错，请更新
manhood 已知	翻译出错，请更新
material 已知	翻译出错，请更新
measures 已知	翻译出错，请更新
misgivings 已知	翻译出错，请更新
monkey 已知	翻译出错，请更新
mothers 已知	翻译出错，请更新
mountains 已知	山脉
music 已知	翻译出错，请更新
names 已知	翻译出错，请更新
nasty 已知	翻译出错，请更新
naughty 已知	翻译出错，请更新
navy 已知	翻译出错，请更新
neglected 已知	翻译出错，请更新
nervous 已知	翻译出错，请更新
nights 已知	翻译出错，请更新
nineteen 已知	翻译出错，请更新
noise 已知	翻译出错，请更新
nose 已知	翻译出错，请更新
offend 已知	翻译出错，请更新
officials 已知	翻译出错，请更新
oh 已知	哎呀哦呵
oneself 已知	翻译出错，请更新
opportunities 已知	翻译出错，请更新
orators 已知	翻译出错，请更新
original 已知	翻译出错，请更新
ours 已知	翻译出错，请更新
papas 已知	翻译出错，请更新
partiality 已知	翻译出错，请更新
patron 已知	翻译出错，请更新
pays 已知	翻译出错，请更新
perilous 已知	翻译出错，请更新
permit 已知	翻译出错，请更新
piece 已知	翻译出错，请更新
pink 已知	翻译出错，请更新
politically 已知	翻译出错，请更新
ponderous 已知	翻译出错，请更新
popularity 已知	翻译出错，请更新
portfolio 已知	翻译出错，请更新
portrait 已知	翻译出错，请更新
presented 已知	翻译出错，请更新
preserved 已知	翻译出错，请更新
price 已知	翻译出错，请更新
privileges 已知	翻译出错，请更新
proceed 已知	翻译出错，请更新
procession 已知	翻译出错，请更新
professional 已知	翻译出错，请更新
progress 已知	翻译出错，请更新
promising 已知	翻译出错，请更新
prone 已知	翻译出错，请更新
pronounced 已知	翻译出错，请更新
proof 已知	翻译出错，请更新
protect 已知	翻译出错，请更新
protection 已知	翻译出错，请更新
provided 已知	翻译出错，请更新
pulled 已知	翻译出错，请更新
punishment 已知	翻译出错，请更新
questioned 已知	翻译出错，请更新
rebuked 已知	翻译出错，请更新
receipt 已知	翻译出错，请更新
recognised 已知	翻译出错，请更新
regular 已知	翻译出错，请更新
relatives 已知	翻译出错，请更新
reminding 已知	翻译出错，请更新
repay 已知	翻译出错，请更新
repeat 已知	翻译出错，请更新
revenge 已知	翻译出错，请更新
rides 已知	翻译出错，请更新
riot 已知	翻译出错，请更新
risen 已知	翻译出错，请更新
route 已知	翻译出错，请更新
royal 已知	皇家
ruffian 已知	翻译出错，请更新
savagely 已知	翻译出错，请更新
scheme 已知	翻译出错，请更新
school 已知	翻译出错，请更新
scolding 已知	翻译出错，请更新
seeming 已知	翻译出错，请更新
selection 已知	翻译出错，请更新
semipolitical 已知	翻译出错，请更新
sentences 已知	翻译出错，请更新
separation 已知	翻译出错，请更新
serving 已知	翻译出错，请更新
seventeen 已知	十七
seventy 已知	翻译出错，请更新
shaken 已知	翻译出错，请更新
shape 已知	翻译出错，请更新
shell 已知	翻译出错，请更新
shortly 已知	翻译出错，请更新
shows 已知	翻译出错，请更新
shut 已知	翻译出错，请更新
signify 已知	翻译出错，请更新
silk 已知	翻译出错，请更新
sincere 已知	翻译出错，请更新
singular 已知	翻译出错，请更新
sins 已知	翻译出错，请更新
sittingroom 已知	翻译出错，请更新
smokingroom 已知	翻译出错，请更新
sober 已知	翻译出错，请更新
solemnity 已知	翻译出错，请更新
sources 已知	翻译出错，请更新
stable 已知	翻译出错，请更新
stands 已知	翻译出错，请更新
stars 已知	翻译出错，请更新
statesman 已知	翻译出错，请更新
stones 已知	翻译出错，请更新
stories 已知	翻译出错，请更新
strain 已知	翻译出错，请更新
striving 已知	翻译出错，请更新
strove 已知	翻译出错，请更新
stupid 已知	翻译出错，请更新
submitted 已知	翻译出错，请更新
sum 已知	翻译出错，请更新
superiors 已知	翻译出错，请更新
supporter 已知	翻译出错，请更新
supposing 已知	翻译出错，请更新
swearing 已知	翻译出错，请更新
tables 已知	翻译出错，请更新
tailor 已知	翻译出错，请更新
taunted 已知	翻译出错，请更新
tend 已知	翻译出错，请更新
tendency 已知	翻译出错，请更新
tendered 已知	翻译出错，请更新
theories 已知	翻译出错，请更新
theyve 已知	他们有
thin 已知	翻译出错，请更新
transfer 已知	翻译出错，请更新
treasure 已知	翻译出错，请更新
trusting 已知	翻译出错，请更新
ugly 已知	翻译出错，请更新
uncourteous 已知	翻译出错，请更新
unfitted 已知	翻译出错，请更新
unhappiness 已知	翻译出错，请更新
upwards 已知	翻译出错，请更新
utmost 已知	翻译出错，请更新
valuable 已知	翻译出错，请更新
wall 已知	翻译出错，请更新
walls 已知	翻译出错，请更新
warmth 已知	翻译出错，请更新
waterfall 已知	翻译出错，请更新
wellnigh 已知	翻译出错，请更新
wheels 已知	翻译出错，请更新
whence 已知	翻译出错，请更新
wholly 已知	翻译出错，请更新
widow 已知	翻译出错，请更新
wing 已知	翻译出错，请更新
wings 已知	翻译出错，请更新
wiser 已知	翻译出错，请更新
withdrawn 已知	翻译出错，请更新
wondered 已知	翻译出错，请更新
works 已知	翻译出错，请更新
youngest 已知	翻译出错，请更新
zeal 已知	翻译出错，请更新
America 已知	翻译出错，请更新
Another 已知	翻译出错，请更新
April 已知	翻译出错，请更新
Beans 已知	翻译出错，请更新
Bedford 已知	翻译出错，请更新
Bench 已知	翻译出错，请更新
Between 已知	翻译出错，请更新
Both 已知	翻译出错，请更新
Bruges 已知	翻译出错，请更新
Carlisle 已知	翻译出错，请更新
Catholic 已知	翻译出错，请更新
Coldfoot 已知	翻译出错，请更新
Council 已知	翻译出错，请更新
Dover 已知	翻译出错，请更新
East 已知	翻译出错，请更新
Ennis 已知	翻译出错，请更新
Equity 已知	翻译出错，请更新
Faint 已知	翻译出错，请更新
Fancy 已知	翻译出错，请更新
General 已知	翻译出错，请更新
Guards 已知	翻译出错，请更新
Harry 已知	翻译出错，请更新
Havent 已知	翻译出错，请更新
Hon 已知	翻译出错，请更新
Horns 已知	翻译出错，请更新
Hundreds 已知	翻译出错，请更新
James 已知	翻译出错，请更新
Kent 已知	翻译出错，请更新
Life 已知	翻译出错，请更新
Lincolnshire 已知	翻译出错，请更新
Looking 已知	翻译出错，请更新
Love 已知	翻译出错，请更新
Lower 已知	翻译出错，请更新
Many 已知	翻译出错，请更新
Mayo 已知	翻译出错，请更新
Money 已知	翻译出错，请更新
Newmarket 已知	翻译出错，请更新
Nonsense 已知	翻译出错，请更新
Northamptonshire 已知	翻译出错，请更新
OB 已知	翻译出错，请更新
OC 已知	翻译出错，请更新
OD 已知	翻译出错，请更新
OShaughnessy 已知	翻译出错，请更新
Phinny 已知	翻译出错，请更新
Planty 已知	翻译出错，请更新
Privy 已知	翻译出错，请更新
Radicals 已知	翻译出错，请更新
Rumours 已知	翻译出错，请更新
Seal 已知	翻译出错，请更新
Send 已知	翻译出错，请更新
Shakspeare 已知	翻译出错，请更新
Shall 已知	翻译出错，请更新
Shannon 已知	翻译出错，请更新
Sometimes 已知	翻译出错，请更新
Soon 已知	翻译出错，请更新
Stamford 已知	翻译出错，请更新
Tenant 已知	翻译出错，请更新
Therefore 已知	翻译出错，请更新
Three 已知	翻译出错，请更新
Thrift 已知	翻译出错，请更新
United 已知	翻译出错，请更新
ViceChancellors 已知	翻译出错，请更新
War 已知	翻译出错，请更新
Windsor 已知	翻译出错，请更新
Within 已知	翻译出错，请更新
Youve 已知	翻译出错，请更新
abruptly 已知	翻译出错，请更新
abstain 已知	翻译出错，请更新
abstained 已知	翻译出错，请更新
abstract 已知	翻译出错，请更新
absurdity 已知	翻译出错，请更新
accompany 已知	翻译出错，请更新
accomplished 已知	翻译出错，请更新
accord 已知	翻译出错，请更新
accurate 已知	翻译出错，请更新
accurately 已知	翻译出错，请更新
accuse 已知	翻译出错，请更新
achieve 已知	翻译出错，请更新
actual 已知	翻译出错，请更新
actually 已知	翻译出错，请更新
addition 已知	翻译出错，请更新
adopted 已知	翻译出错，请更新
advance 已知	翻译出错，请更新
adventurer 已知	翻译出错，请更新
adversary 已知	翻译出错，请更新
advised 已知	翻译出错，请更新
affections 已知	翻译出错，请更新
afloat 已知	翻译出错，请更新
agricultural 已知	翻译出错，请更新
altered 已知	翻译出错，请更新
amuse 已知	翻译出错，请更新
angrily 已知	翻译出错，请更新
animosity 已知	翻译出错，请更新
apologise 已知	翻译出错，请更新
apply 已知	翻译出错，请更新
approached 已知	翻译出错，请更新
appropriate 已知	翻译出错，请更新
arisen 已知	翻译出错，请更新
arrogance 已知	翻译出错，请更新
arrows 已知	翻译出错，请更新
art 已知	翻译出错，请更新
assembled 已知	翻译出错，请更新
assume 已知	翻译出错，请更新
astonishing 已知	翻译出错，请更新
ate 已知	翻译出错，请更新
attacked 已知	翻译出错，请更新
attacks 已知	翻译出错，请更新
attractive 已知	翻译出错，请更新
attributed 已知	翻译出错，请更新
audible 已知	翻译出错，请更新
awfully 已知	翻译出错，请更新
banished 已知	翻译出错，请更新
bargain 已知	翻译出错，请更新
batteries 已知	翻译出错，请更新
beard 已知	翻译出错，请更新
beasts 已知	翻译出错，请更新
beating 已知	翻译出错，请更新
bedroom 已知	翻译出错，请更新
beer 已知	翻译出错，请更新
believes 已知	翻译出错，请更新
bend 已知	翻译出错，请更新
bent 已知	翻译出错，请更新
bishops 已知	翻译出错，请更新
bitterest 已知	翻译出错，请更新
bitterly 已知	翻译出错，请更新
bitterness 已知	翻译出错，请更新
blackguard 已知	翻译出错，请更新
bloom 已知	翻译出错，请更新
blush 已知	翻译出错，请更新
board 已知	翻译出错，请更新
boldfaced 已知	翻译出错，请更新
bonds 已知	翻译出错，请更新
bone 已知	翻译出错，请更新
borne 已知	翻译出错，请更新
bottle 已知	翻译出错，请更新
braes 已知	丘陵
brains 已知	翻译出错，请更新
bridges 已知	翻译出错，请更新
brightness 已知	翻译出错，请更新
brook 已知	小溪
busy 已知	翻译出错，请更新
butter 已知	翻译出错，请更新
bye 已知	翻译出错，请更新
calumet 已知	翻译出错，请更新
canvass 已知	翻译出错，请更新
capital 已知	翻译出错，请更新
cats 已知	翻译出错，请更新
cautious 已知	翻译出错，请更新
ceremony 已知	翻译出错，请更新
cheering 已知	翻译出错，请更新
cheery 已知	翻译出错，请更新
chess 已知	翻译出错，请更新
city 已知	翻译出错，请更新
clearness 已知	翻译出错，请更新
climb 已知	翻译出错，请更新
clothes 已知	翻译出错，请更新
coach 已知	翻译出错，请更新
combat 已知	翻译出错，请更新
combination 已知	翻译出错，请更新
combine 已知	翻译出错，请更新
comeliness 已知	翻译出错，请更新
commencement 已知	翻译出错，请更新
compensation 已知	翻译出错，请更新
complaining 已知	翻译出错，请更新
completely 已知	翻译出错，请更新
compliance 已知	翻译出错，请更新
conceal 已知	翻译出错，请更新
conclusion 已知	翻译出错，请更新
confidential 已知	翻译出错，请更新
congratulations 已知	翻译出错，请更新
conquered 已知	翻译出错，请更新
consciousness 已知	翻译出错，请更新
constrained 已知	翻译出错，请更新
contact 已知	翻译出错，请更新
contempt 已知	翻译出错，请更新
controlled 已知	翻译出错，请更新
convenience 已知	翻译出错，请更新
convenient 已知	翻译出错，请更新
convince 已知	翻译出错，请更新
cool 已知	翻译出错，请更新
cordially 已知	翻译出错，请更新
counselled 已知	翻译出错，请更新
countrys 已知	翻译出错，请更新
courtesy 已知	翻译出错，请更新
covering 已知	翻译出错，请更新
crisis 已知	翻译出错，请更新
crying 已知	翻译出错，请更新
custody 已知	翻译出错，请更新
custom 已知	翻译出错，请更新
dash 已知	翻译出错，请更新
daughterinlaw 已知	翻译出错，请更新
dearer 已知	翻译出错，请更新
decency 已知	翻译出错，请更新
declaration 已知	翻译出错，请更新
deed 已知	翻译出错，请更新
defeat 已知	翻译出错，请更新
delivered 已知	翻译出错，请更新
demeanour 已知	翻译出错，请更新
democratic 已知	翻译出错，请更新
denied 已知	翻译出错，请更新
depart 已知	翻译出错，请更新
depressed 已知	翻译出错，请更新
desert 已知	翻译出错，请更新
desertion 已知	翻译出错，请更新
despair 已知	翻译出错，请更新
destroyed 已知	翻译出错，请更新
detained 已知	翻译出错，请更新
deter 已知	翻译出错，请更新
devils 已知	翻译出错，请更新
dirt 已知	翻译出错，请更新
dirty 已知	翻译出错，请更新
discretion 已知	翻译出错，请更新
disgraceful 已知	翻译出错，请更新
displeasure 已知	翻译出错，请更新
disposal 已知	翻译出错，请更新
dissolved 已知	翻译出错，请更新
district 已知	翻译出错，请更新
divine 已知	翻译出错，请更新
doctrine 已知	翻译出错，请更新
draw 已知	翻译出错，请更新
drawback 已知	翻译出错，请更新
dreamed 已知	翻译出错，请更新
dreaming 已知	翻译出错，请更新
dreams 已知	翻译出错，请更新
dressing 已知	翻译出错，请更新
drinking 已知	翻译出错，请更新
driving 已知	翻译出错，请更新
dumbbells 已知	翻译出错，请更新
dye 已知	翻译出错，请更新
eagerness 已知	翻译出错，请更新
earliest 已知	翻译出错，请更新
education 已知	翻译出错，请更新
effected 已知	翻译出错，请更新
elated 已知	翻译出错，请更新
employment 已知	翻译出错，请更新
entertain 已知	翻译出错，请更新
envelope 已知	翻译出错，请更新
especial 已知	翻译出错，请更新
events 已知	翻译出错，请更新
excuses 已知	翻译出错，请更新
existence 已知	翻译出错，请更新
exists 已知	翻译出错，请更新
expecting 已知	翻译出错，请更新
explanations 已知	翻译出错，请更新
failing 已知	翻译出错，请更新
failures 已知	翻译出错，请更新
fainant 已知	翻译出错，请更新
faithfully 已知	翻译出错，请更新
fame 已知	翻译出错，请更新
famous 已知	翻译出错，请更新
farther 已知	翻译出错，请更新
farthing 已知	翻译出错，请更新
faults 已知	翻译出错，请更新
fearful 已知	翻译出错，请更新
fences 已知	翻译出错，请更新
fickleness 已知	翻译出错，请更新
fiery 已知	翻译出错，请更新
fifth 已知	翻译出错，请更新
final 已知	翻译出错，请更新
fitting 已知	翻译出错，请更新
flowers 已知	翻译出错，请更新
footing 已知	翻译出错，请更新
footsteps 已知	翻译出错，请更新
forlorn 已知	翻译出错，请更新
forms 已知	翻译出错，请更新
fortnight 已知	翻译出错，请更新
fox 已知	翻译出错，请更新
franchises 已知	翻译出错，请更新
freely 已知	翻译出错，请更新
frown 已知	翻译出错，请更新
gag 已知	翻译出错，请更新
gallery 已知	翻译出错，请更新
gardens 已知	翻译出错，请更新
garments 已知	翻译出错，请更新
generosity 已知	翻译出错，请更新
genius 已知	翻译出错，请更新
gently 已知	翻译出错，请更新
glories 已知	翻译出错，请更新
gold 已知	翻译出错，请更新
grandfather 已知	翻译出错，请更新
gravely 已知	翻译出错，请更新
groom 已知	翻译出错，请更新
groove 已知	翻译出错，请更新
guarded 已知	翻译出错，请更新
guess 已知	翻译出错，请更新
halfmad 已知	翻译出错，请更新
hanging 已知	翻译出错，请更新
haste 已知	翻译出错，请更新
hatred 已知	翻译出错，请更新
hears 已知	翻译出错，请更新
height 已知	翻译出错，请更新
helped 已知	翻译出错，请更新
hesitate 已知	翻译出错，请更新
hill 已知	山丘
hired 已知	翻译出错，请更新
hosts 已知	翻译出错，请更新
huge 已知	翻译出错，请更新
hung 已知	翻译出错，请更新
import 已知	翻译出错，请更新
inconvenience 已知	翻译出错，请更新
incur 已知	翻译出错，请更新
indulge 已知	翻译出错，请更新
infinite 已知	翻译出错，请更新
influential 已知	翻译出错，请更新
informed 已知	翻译出错，请更新
inhabitants 已知	翻译出错，请更新
injurious 已知	翻译出错，请更新
innocent 已知	翻译出错，请更新
inquired 已知	翻译出错，请更新
insisted 已知	翻译出错，请更新
instructions 已知	翻译出错，请更新
insulted 已知	翻译出错，请更新
intending 已知	翻译出错，请更新
interrogated 已知	翻译出错，请更新
interval 已知	翻译出错，请更新
intimately 已知	翻译出错，请更新
intimation 已知	翻译出错，请更新
introduction 已知	翻译出错，请更新
inward 已知	翻译出错，请更新
jealous 已知	翻译出错，请更新
job 已知	翻译出错，请更新
joking 已知	翻译出错，请更新
journeyman 已知	翻译出错，请更新
judged 已知	翻译出错，请更新
jump 已知	翻译出错，请更新
knee 已知	翻译出错，请更新
knock 已知	翻译出错，请更新
lace 已知	翻译出错，请更新
lackuey 已知	翻译出错，请更新
laird 已知	翻译出错，请更新
laughter 已知	翻译出错，请更新
leap 已知	翻译出错，请更新
lent 已知	翻译出错，请更新
lest 已知	翻译出错，请更新
liberated 已知	翻译出错，请更新
lion 已知	翻译出错，请更新
livery 已知	翻译出错，请更新
loudly 已知	翻译出错，请更新
luncheon 已知	翻译出错，请更新
mar 已知	翻译出错，请更新
marked 已知	翻译出错，请更新
marvellous 已知	翻译出错，请更新
masses 已知	翻译出错，请更新
meddle 已知	翻译出错，请更新
mentor 已知	翻译出错，请更新
mercy 已知	翻译出错，请更新
mess 已知	翻译出错，请更新
mice 已知	翻译出错，请更新
mighty 已知	翻译出错，请更新
mischief 已知	翻译出错，请更新
mock 已知	翻译出错，请更新
moderate 已知	翻译出错，请更新
modest 已知	翻译出错，请更新
morrow 已知	翻译出错，请更新
motherly 已知	翻译出错，请更新
mount 已知	山
mouths 已知	翻译出错，请更新
movements 已知	翻译出错，请更新
muttered 已知	翻译出错，请更新
mutual 已知	翻译出错，请更新
n 已知	翻译出错，请更新
necessarily 已知	翻译出错，请更新
nobility 已知	翻译出错，请更新
nonce 已知	翻译出错，请更新
noon 已知	翻译出错，请更新
notes 已知	翻译出错，请更新
objection 已知	翻译出错，请更新
obtaining 已知	翻译出错，请更新
offering 已知	翻译出错，请更新
officers 已知	翻译出错，请更新
operations 已知	翻译出错，请更新
opponent 已知	翻译出错，请更新
opposed 已知	翻译出错，请更新
oratory 已知	翻译出错，请更新
ordinarily 已知	翻译出错，请更新
outward 已知	翻译出错，请更新
owes 已知	翻译出错，请更新
oyster 已知	翻译出错，请更新
painfully 已知	翻译出错，请更新
pair 已知	翻译出错，请更新
pale 已知	翻译出错，请更新
patriotism 已知	翻译出错，请更新
pausing 已知	翻译出错，请更新
pecuniary 已知	翻译出错，请更新
perform 已知	翻译出错，请更新
peril 已知	翻译出错，请更新
persecution 已知	翻译出错，请更新
persevering 已知	翻译出错，请更新
pities 已知	翻译出错，请更新
plead 已知	翻译出错，请更新
pleasanter 已知	翻译出错，请更新
poison 已知	翻译出错，请更新
poker 已知	翻译出错，请更新
policy 已知	翻译出错，请更新
prejudice 已知	翻译出错，请更新
preparation 已知	翻译出错，请更新
prig 已知	翻译出错，请更新
probability 已知	翻译出错，请更新
proclaimed 已知	翻译出错，请更新
project 已知	翻译出错，请更新
proposal 已知	翻译出错，请更新
pulling 已知	翻译出错，请更新
puppet 已知	翻译出错，请更新
pure 已知	翻译出错，请更新
purport 已知	翻译出错，请更新
purposely 已知	翻译出错，请更新
questioner 已知	翻译出错，请更新
quoted 已知	翻译出错，请更新
rage 已知	翻译出错，请更新
rash 已知	翻译出错，请更新
rd 已知	翻译出错，请更新
readers 已知	翻译出错，请更新
realise 已知	翻译出错，请更新
rebuke 已知	翻译出错，请更新
recess 已知	翻译出错，请更新
recognise 已知	翻译出错，请更新
redress 已知	翻译出错，请更新
reelection 已知	翻译出错，请更新
reflected 已知	翻译出错，请更新
reformers 已知	翻译出错，请更新
refrain 已知	翻译出错，请更新
refusing 已知	翻译出错，请更新
reject 已知	翻译出错，请更新
rejection 已知	翻译出错，请更新
relation 已知	翻译出错，请更新
relieved 已知	翻译出错，请更新
religion 已知	翻译出错，请更新
reporters 已知	翻译出错，请更新
reproaches 已知	翻译出错，请更新
requested 已知	翻译出错，请更新
requires 已知	翻译出错，请更新
resented 已知	翻译出错，请更新
rested 已知	翻译出错，请更新
results 已知	翻译出错，请更新
retired 已知	翻译出错，请更新
retreating 已知	翻译出错，请更新
returning 已知	翻译出错，请更新
richer 已知	翻译出错，请更新
ridiculous 已知	翻译出错，请更新
rotten 已知	翻译出错，请更新
roughs 已知	翻译出错，请更新
ruby 已知	翻译出错，请更新
ruck 已知	翻译出错，请更新
rung 已知	翻译出错，请更新
rushing 已知	翻译出错，请更新
sadly 已知	翻译出错，请更新
satire 已知	翻译出错，请更新
savagery 已知	翻译出错，请更新
seconds 已知	翻译出错，请更新
security 已知	翻译出错，请更新
seriously 已知	翻译出错，请更新
services 已知	翻译出错，请更新
settlements 已知	翻译出错，请更新
severely 已知	翻译出错，请更新
sheet 已知	翻译出错，请更新
shoes 已知	翻译出错，请更新
sing 已知	翻译出错，请更新
slave 已知	翻译出错，请更新
sleep 已知	翻译出错，请更新
smallest 已知	翻译出错，请更新
smoking 已知	翻译出错，请更新
soldiers 已知	翻译出错，请更新
solicitude 已知	翻译出错，请更新
spark 已知	翻译出错，请更新
sphere 已知	翻译出错，请更新
spirits 已知	翻译出错，请更新
spoil 已知	翻译出错，请更新
spoilt 已知	翻译出错，请更新
spots 已知	翻译出错，请更新
stain 已知	翻译出错，请更新
stated 已知	翻译出错，请更新
station 已知	翻译出错，请更新
staunch 已知	翻译出错，请更新
stepped 已知	翻译出错，请更新
stout 已知	翻译出错，请更新
straggling 已知	翻译出错，请更新
stream 已知	翻译出错，请更新
strive 已知	翻译出错，请更新
stronger 已知	翻译出错，请更新
subjected 已知	翻译出错，请更新
suffering 已知	翻译出错，请更新
supporters 已知	翻译出错，请更新
surmised 已知	翻译出错，请更新
swallowed 已知	翻译出错，请更新
tear 已知	翻译出错，请更新
tedious 已知	翻译出错，请更新
term 已知	翻译出错，请更新
terrace 已知	翻译出错，请更新
thanks 已知	翻译出错，请更新
thoughtful 已知	翻译出错，请更新
threat 已知	翻译出错，请更新
tradesmen 已知	翻译出错，请更新
traitor 已知	翻译出错，请更新
travelling 已知	翻译出错，请更新
tree 已知	翻译出错，请更新
trick 已知	翻译出错，请更新
trip 已知	翻译出错，请更新
tumbling 已知	翻译出错，请更新
tyranny 已知	翻译出错，请更新
uncivil 已知	翻译出错，请更新
unconsciously 已知	翻译出错，请更新
undoubtedly 已知	毋庸置疑
urged 已知	翻译出错，请更新
using 已知	翻译出错，请更新
utterance 已知	翻译出错，请更新
uttering 已知	翻译出错，请更新
vacancy 已知	翻译出错，请更新
vestige 已知	翻译出错，请更新
vices 已知	翻译出错，请更新
vigour 已知	翻译出错，请更新
virtue 已知	翻译出错，请更新
virtues 已知	翻译出错，请更新
visited 已知	翻译出错，请更新
visits 已知	翻译出错，请更新
wake 已知	翻译出错，请更新
wearisome 已知	翻译出错，请更新
weekly 已知	翻译出错，请更新
weeping 已知	翻译出错，请更新
wellknown 已知	翻译出错，请更新
whatsoever 已知	翻译出错，请更新
whip 已知	翻译出错，请更新
whirlwind 已知	翻译出错，请更新
winds 已知	翻译出错，请更新
winning 已知	翻译出错，请更新
wipe 已知	翻译出错，请更新
worlds 已知	翻译出错，请更新
worn 已知	翻译出错，请更新
wretchedness 已知	翻译出错，请更新
wronged 已知	翻译出错，请更新
yards 已知	翻译出错，请更新
yellow 已知	翻译出错，请更新
Aint 已知	翻译出错，请更新
Alas 已知	翻译出错，请更新
American 已知	翻译出错，请更新
Among 已知	翻译出错，请更新
Answer 已知	翻译出错，请更新
Ask 已知	翻译出错，请更新
Believe 已知	翻译出错，请更新
Brussels 已知	翻译出错，请更新
C 已知	翻译出错，请更新
CHILTERN 已知	翻译出错，请更新
Calais 已知	翻译出错，请更新
Canadians 已知	翻译出错，请更新
Cayenne 已知	翻译出错，请更新
Chancery 已知	翻译出错，请更新
Courts 已知	翻译出错，请更新
Didnt 已知	翻译出错，请更新
Duggin 已知	翻译出错，请更新
Elias 已知	翻译出错，请更新
Englands 已知	翻译出错，请更新
F 已知	翻译出错，请更新
Fortune 已知	翻译出错，请更新
Fox 已知	翻译出错，请更新
French 已知	翻译出错，请更新
Gods 已知	翻译出错，请更新
Going 已知	翻译出错，请更新
Goodnight 已知	翻译出错，请更新
Gorse 已知	翻译出错，请更新
Gunning 已知	翻译出错，请更新
Half 已知	翻译出错，请更新
Halifax 已知	翻译出错，请更新
Heavens 已知	翻译出错，请更新
Hitherto 已知	翻译出错，请更新
Honourable 已知	翻译出错，请更新
Hotel 已知	翻译出错，请更新
Howard 已知	翻译出错，请更新
India 已知	翻译出错，请更新
Irishmen 已知	翻译出错，请更新
Isnt 已知	翻译出错，请更新
January 已知	翻译出错，请更新
Jew 已知	翻译出错，请更新
KENNEDY 已知	翻译出错，请更新
LAURA 已知	翻译出错，请更新
Laird 已知	翻译出错，请更新
Lambert 已知	翻译出错，请更新
Larrence 已知	翻译出错，请更新
Latin 已知	翻译出错，请更新
Law 已知	翻译出错，请更新
Legge 已知	翻译出错，请更新
Listen 已知	翻译出错，请更新
Lochinvar 已知	翻译出错，请更新
Lotta 已知	翻译出错，请更新
Lough 已知	翻译出错，请更新
Loughshaners 已知	翻译出错，请更新
MARIE 已知	翻译出错，请更新
MP 已知	翻译出错，请更新
Mackenzies 已知	翻译出错，请更新
Macleod 已知	翻译出错，请更新
Mamma 已知	翻译出错，请更新
Matilda 已知	翻译出错，请更新
Meg 已知	翻译出错，请更新
Mercury 已知	翻译出错，请更新
Messrs 已知	翻译出错，请更新
Morrison 已知	翻译出错，请更新
Mouser 已知	翻译出错，请更新
Omniums 已知	翻译出错，请更新
Orchard 已知	翻译出错，请更新
Pjinskt 已知	翻译出错，请更新
Pouncefoot 已知	翻译出错，请更新
Probably 已知	翻译出错，请更新
Richmond 已知	翻译出错，请更新
Rivers 已知	翻译出错，请更新
Rocky 已知	翻译出错，请更新
Russian 已知	翻译出错，请更新
Satan 已知	翻译出错，请更新
Secretaries 已知	翻译出错，请更新
Seeing 已知	翻译出错，请更新
Smotherem 已知	翻译出错，请更新
Somebody 已知	翻译出错，请更新
Sparrowsky 已知	翻译出错，请更新
Stop 已知	翻译出错，请更新
Telegraph 已知	翻译出错，请更新
Ten 已知	翻译出错，请更新
Thames 已知	翻译出错，请更新
Thanks 已知	翻译出错，请更新
Therell 已知	翻译出错，请更新
Things 已知	翻译出错，请更新
Times 已知	翻译出错，请更新
Too 已知	翻译出错，请更新
Trinity 已知	翻译出错，请更新
Tullas 已知	翻译出错，请更新
Twelve 已知	翻译出错，请更新
Twice 已知	翻译出错，请更新
V 已知	翻译出错，请更新
Virgin 已知	翻译出错，请更新
Walter 已知	翻译出错，请更新
West 已知	翻译出错，请更新
Western 已知	翻译出错，请更新
Weve 已知	翻译出错，请更新
Whip 已知	翻译出错，请更新
Whom 已知	翻译出错，请更新
Wilson 已知	翻译出错，请更新
Wood 已知	翻译出错，请更新
Zealand 已知	翻译出错，请更新
abandoned 已知	翻译出错，请更新
ability 已知	翻译出错，请更新
absolved 已知	翻译出错，请更新
abundance 已知	翻译出错，请更新
acceptance 已知	翻译出错，请更新
accomplishment 已知	翻译出错，请更新
accursed 已知	翻译出错，请更新
ache 已知	翻译出错，请更新
acquired 已知	翻译出错，请更新
acre 已知	英亩
acres 已知	翻译出错，请更新
add 已知	翻译出错，请更新
adjust 已知	翻译出错，请更新
adverse 已知	翻译出错，请更新
affected 已知	翻译出错，请更新
afflicted 已知	翻译出错，请更新
afforded 已知	翻译出错，请更新
ages 已知	翻译出错，请更新
agreement 已知	翻译出错，请更新
aim 已知	翻译出错，请更新
airs 已知	翻译出错，请更新
allows 已知	翻译出错，请更新
alternatives 已知	翻译出错，请更新
amendment 已知	翻译出错，请更新
annoy 已知	翻译出错，请更新
answers 已知	翻译出错，请更新
anybodys 已知	翻译出错，请更新
apartment 已知	翻译出错，请更新
apologies 已知	翻译出错，请更新
applied 已知	翻译出错，请更新
appreciation 已知	翻译出错，请更新
approve 已知	翻译出错，请更新
approved 已知	翻译出错，请更新
aright 已知	翻译出错，请更新
arising 已知	翻译出错，请更新
aroused 已知	翻译出错，请更新
arrest 已知	翻译出错，请更新
articles 已知	翻译出错，请更新
asleep 已知	翻译出错，请更新
aspirants 已知	翻译出错，请更新
assented 已知	翻译出错，请更新
assisted 已知	翻译出错，请更新
assuredly 已知	翻译出错，请更新
astonishment 已知	翻译出错，请更新
asunder 已知	翻译出错，请更新
atoms 已知	翻译出错，请更新
attempts 已知	翻译出错，请更新
attendance 已知	翻译出错，请更新
attendant 已知	翻译出错，请更新
attentive 已知	翻译出错，请更新
attorney 已知	General 司法部长；总检察长
aunts 已知	翻译出错，请更新
available 已知	翻译出错，请更新
aversion 已知	翻译出错，请更新
await 已知	翻译出错，请更新
awkwardly 已知	翻译出错，请更新
bade 已知	翻译出错，请更新
bandages 已知	翻译出错，请更新
banker 已知	翻译出错，请更新
banquet 已知	翻译出错，请更新
bar 已知	翻译出错，请更新
base 已知	翻译出错，请更新
battles 已知	翻译出错，请更新
befallen 已知	翻译出错，请更新
beforehand 已知	翻译出错，请更新
behaving 已知	翻译出错，请更新
belongs 已知	翻译出错，请更新
benefit 已知	翻译出错，请更新
bestowed 已知	翻译出错，请更新
betrayed 已知	翻译出错，请更新
biddings 已知	翻译出错，请更新
bigger 已知	翻译出错，请更新
bind 已知	翻译出错，请更新
blacker 已知	翻译出错，请更新
blank 已知	翻译出错，请更新
blooming 已知	翻译出错，请更新
blown 已知	翻译出错，请更新
blundered 已知	翻译出错，请更新
boots 已知	翻译出错，请更新
bravely 已知	翻译出错，请更新
breach 已知	翻译出错，请更新
breaks 已知	翻译出错，请更新
breeches 已知	翻译出错，请更新
brewery 已知	翻译出错，请更新
brilliant 已知	翻译出错，请更新
brings 已知	翻译出错，请更新
brotherinlaw 已知	翻译出错，请更新
brows 已知	翻译出错，请更新
bruised 已知	翻译出错，请更新
buckram 已知	翻译出错，请更新
bullet 已知	翻译出错，请更新
burdened 已知	翻译出错，请更新
bystander 已知	翻译出错，请更新
c 已知	翻译出错，请更新
calamity 已知	翻译出错，请更新
calculation 已知	翻译出错，请更新
calves 已知	翻译出错，请更新
cantering 已知	翻译出错，请更新
cap 已知	翻译出错，请更新
capacity 已知	翻译出错，请更新
captain 已知	翻译出错，请更新
cat 已知	翻译出错，请更新
catalogue 已知	翻译出错，请更新
cease 已知	翻译出错，请更新
champagne 已知	翻译出错，请更新
chanced 已知	翻译出错，请更新
cheap 已知	翻译出错，请更新
check 已知	翻译出错，请更新
cheque 已知	翻译出错，请更新
china 已知	翻译出错，请更新
civility 已知	翻译出错，请更新
clerks 已知	翻译出错，请更新
cling 已知	翻译出错，请更新
cloud 已知	翻译出错，请更新
coercion 已知	翻译出错，请更新
coldly 已知	翻译出错，请更新
collar 已知	翻译出错，请更新
collecting 已知	翻译出错，请更新
college 已知	翻译出错，请更新
comer 已知	翻译出错，请更新
commandment 已知	翻译出错，请更新
commandments 已知	翻译出错，请更新
commands 已知	翻译出错，请更新
commercial 已知	翻译出错，请更新
commissioned 已知	翻译出错，请更新
commonsense 已知	翻译出错，请更新
companies 已知	翻译出错，请更新
companionship 已知	翻译出错，请更新
comparative 已知	翻译出错，请更新
compared 已知	翻译出错，请更新
compliment 已知	翻译出错，请更新
composed 已知	翻译出错，请更新
composition 已知	翻译出错，请更新
conceited 已知	翻译出错，请更新
concourse 已知	翻译出错，请更新
concurred 已知	翻译出错，请更新
condemn 已知	翻译出错，请更新
conferred 已知	翻译出错，请更新
confused 已知	翻译出错，请更新
confusion 已知	翻译出错，请更新
congenial 已知	翻译出错，请更新
congratulated 已知	翻译出错，请更新
congratulation 已知	翻译出错，请更新
conscientiously 已知	翻译出错，请更新
considering 已知	翻译出错，请更新
consulted 已知	翻译出错，请更新
contradicted 已知	翻译出错，请更新
contrived 已知	翻译出错，请更新
convey 已知	翻译出错，请更新
cordiality 已知	翻译出错，请更新
correctly 已知	翻译出错，请更新
correspondent 已知	翻译出错，请更新
covered 已知	翻译出错，请更新
cowardice 已知	翻译出错，请更新
cowards 已知	翻译出错，请更新
creating 已知	翻译出错，请更新
cried 已知	翻译出错，请更新
crime 已知	翻译出错，请更新
criminal 已知	翻译出错，请更新
crushing 已知	翻译出错，请更新
cultivation 已知	翻译出错，请更新
curls 已知	翻译出错，请更新
customary 已知	翻译出错，请更新
cutting 已知	翻译出错，请更新
dares 已知	翻译出错，请更新
darling 已知	翻译出错，请更新
date 已知	翻译出错，请更新
dated 已知	翻译出错，请更新
dates 已知	翻译出错，请更新
debarred 已知	翻译出错，请更新
deceived 已知	翻译出错，请更新
deeper 已知	翻译出错，请更新
delights 已知	翻译出错，请更新
deliver 已知	翻译出错，请更新
depends 已知	翻译出错，请更新
descend 已知	翻译出错，请更新
descended 已知	翻译出错，请更新
describing 已知	翻译出错，请更新
deserve 已知	翻译出错，请更新
desiring 已知	翻译出错，请更新
desolation 已知	翻译出错，请更新
despondent 已知	翻译出错，请更新
detail 已知	翻译出错，请更新
deterred 已知	翻译出错，请更新
dictate 已知	翻译出错，请更新
died 已知	翻译出错，请更新
dinnerparty 已知	翻译出错，请更新
disagreement 已知	翻译出错，请更新
discourse 已知	翻译出错，请更新
dishonesty 已知	翻译出错，请更新
dismayed 已知	翻译出错，请更新
display 已知	翻译出错，请更新
displeased 已知	翻译出错，请更新
displeasing 已知	翻译出错，请更新
disreputable 已知	翻译出错，请更新
doings 已知	翻译出错，请更新
dominant 已知	翻译出错，请更新
doubly 已知	翻译出错，请更新
dove 已知	翻译出错，请更新
drudgery 已知	翻译出错，请更新
dullness 已知	翻译出错，请更新
dumb 已知	翻译出错，请更新
earls 已知	翻译出错，请更新
earnestly 已知	翻译出错，请更新
earns 已知	翻译出错，请更新
educated 已知	翻译出错，请更新
effective 已知	翻译出错，请更新
efficacy 已知	翻译出错，请更新
eh 已知	翻译出错，请更新
elaborate 已知	翻译出错，请更新
elbow 已知	翻译出错，请更新
elect 已知	翻译出错，请更新
embarrassment 已知	翻译出错，请更新
engagements 已知	翻译出错，请更新
envied 已知	翻译出错，请更新
estate 已知	翻译出错，请更新
esteemed 已知	翻译出错，请更新
exceedingly 已知	翻译出错，请更新
exchanged 已知	翻译出错，请更新
excited 已知	翻译出错，请更新
exclusively 已知	翻译出错，请更新
excused 已知	翻译出错，请更新
expressly 已知	翻译出错，请更新
extra 已知	翻译出错，请更新
fabrication 已知	翻译出错，请更新
factious 已知	翻译出错，请更新
falsely 已知	翻译出错，请更新
falseness 已知	翻译出错，请更新
familiarly 已知	翻译出错，请更新
farm 已知	翻译出错，请更新
farmers 已知	翻译出错，请更新
fatted 已知	翻译出错，请更新
favourites 已知	翻译出错，请更新
fearing 已知	翻译出错，请更新
feather 已知	翻译出错，请更新
fellowship 已知	翻译出错，请更新
ferment 已知	翻译出错，请更新
fib 已知	翻译出错，请更新
finish 已知	翻译出错，请更新
firm 已知	翻译出错，请更新
firmly 已知	翻译出错，请更新
fish 已知	翻译出错，请更新
fist 已知	翻译出错，请更新
fitted 已知	翻译出错，请更新
fled 已知	翻译出错，请更新
flies 已知	翻译出错，请更新
flock 已知	翻译出错，请更新
flood 已知	洪水
flush 已知	翻译出错，请更新
fly 已知	翻译出错，请更新
foe 已知	翻译出错，请更新
foes 已知	翻译出错，请更新
folk 已知	翻译出错，请更新
foolishly 已知	翻译出错，请更新
fools 已知	翻译出错，请更新
forest 已知	翻译出错，请更新
formal 已知	翻译出错，请更新
formerly 已知	翻译出错，请更新
forming 已知	翻译出错，请更新
fortythree 已知	翻译出错，请更新
fourth 已知	翻译出错，请更新
frightened 已知	翻译出错，请更新
frost 已知	翻译出错，请更新
frowned 已知	翻译出错，请更新
fruit 已知	翻译出错，请更新
furious 已知	翻译出错，请更新
galleries 已知	翻译出错，请更新
galloped 已知	翻译出错，请更新
gates 已知	翻译出错，请更新
gatherings 已知	翻译出错，请更新
gems 已知	翻译出错，请更新
ghost 已知	翻译出错，请更新
gifted 已知	翻译出错，请更新
gifts 已知	翻译出错，请更新
gingerbread 已知	翻译出错，请更新
goddess 已知	翻译出错，请更新
gods 已知	翻译出错，请更新
goodlooking 已知	翻译出错，请更新
goose 已知	翻译出错，请更新
graceful 已知	翻译出错，请更新
graciously 已知	翻译出错，请更新
graciousness 已知	翻译出错，请更新
grain 已知	翻译出错，请更新
grander 已知	翻译出错，请更新
grandest 已知	翻译出错，请更新
gravity 已知	翻译出错，请更新
greatness 已知	翻译出错，请更新
greyhaired 已知	翻译出错，请更新
grieve 已知	翻译出错，请更新
grieved 已知	翻译出错，请更新
grievous 已知	翻译出错，请更新
guarantees 已知	翻译出错，请更新
guard 已知	翻译出错，请更新
happens 已知	翻译出错，请更新
happily 已知	翻译出错，请更新
harassed 已知	翻译出错，请更新
harder 已知	翻译出错，请更新
hates 已知	翻译出错，请更新
haycocks 已知	翻译出错，请更新
hazard 已知	翻译出错，请更新
headstrong 已知	翻译出错，请更新
health 已知	翻译出错，请更新
hearty 已知	翻译出错，请更新
herd 已知	翻译出错，请更新
hint 已知	翻译出错，请更新
horror 已知	翻译出错，请更新
householders 已知	翻译出错，请更新
households 已知	翻译出错，请更新
humiliation 已知	翻译出错，请更新
hunted 已知	翻译出错，请更新
hurrying 已知	翻译出错，请更新
ice 已知	翻译出错，请更新
illness 已知	翻译出错，请更新
imagination 已知	翻译出错，请更新
imprudence 已知	翻译出错，请更新
inches 已知	翻译出错，请更新
included 已知	翻译出错，请更新
incompetent 已知	翻译出错，请更新
indignant 已知	翻译出错，请更新
indispensable 已知	翻译出错，请更新
individuals 已知	翻译出错，请更新
indulged 已知	翻译出错，请更新
industrious 已知	翻译出错，请更新
industry 已知	翻译出错，请更新
inexpediency 已知	翻译出错，请更新
influences 已知	翻译出错，请更新
inherited 已知	翻译出错，请更新
injuring 已知	翻译出错，请更新
insist 已知	翻译出错，请更新
insolence 已知	翻译出错，请更新
instruction 已知	翻译出错，请更新
intends 已知	翻译出错，请更新
intentions 已知	翻译出错，请更新
interfered 已知	翻译出错，请更新
internecine 已知	翻译出错，请更新
interrupted 已知	翻译出错，请更新
intrude 已知	翻译出错，请更新
intrusion 已知	翻译出错，请更新
invitations 已知	翻译出错，请更新
irksome 已知	翻译出错，请更新
jaw 已知	翻译出错，请更新
joining 已知	翻译出错，请更新
jumped 已知	翻译出错，请更新
jumping 已知	翻译出错，请更新
kicked 已知	翻译出错，请更新
kisses 已知	翻译出错，请更新
knickerbockers 已知	翻译出错，请更新
lacking 已知	翻译出错，请更新
lad 已知	翻译出错，请更新
lakes 已知	翻译出错，请更新
landlady 已知	翻译出错，请更新
lazy 已知	翻译出错，请更新
legislature 已知	翻译出错，请更新
lending 已知	翻译出错，请更新
letting 已知	翻译出错，请更新
library 已知	翻译出错，请更新
lieutenant 已知	翻译出错，请更新
lights 已知	翻译出错，请更新
limits 已知	翻译出错，请更新
lip 已知	翻译出错，请更新
literally 已知	翻译出错，请更新
literary 已知	翻译出错，请更新
lively 已知	翻译出错，请更新
load 已知	翻译出错，请更新
loan 已知	翻译出错，请更新
locked 已知	翻译出错，请更新
lodgers 已知	翻译出错，请更新
lonely 已知	翻译出错，请更新
lovemaking 已知	翻译出错，请更新
lurch 已知	翻译出错，请更新
madness 已知	翻译出错，请更新
magnates 已知	翻译出错，请更新
magnificent 已知	翻译出错，请更新
magnitude 已知	翻译出错，请更新
mail 已知	翻译出错，请更新
majesty 已知	翻译出错，请更新
malady 已知	翻译出错，请更新
marital 已知	翻译出错，请更新
marries 已知	翻译出错，请更新
martyrdom 已知	翻译出错，请更新
mastered 已知	翻译出错，请更新
materially 已知	翻译出错，请更新
maynt 已知	翻译出错，请更新
meat 已知	翻译出错，请更新
mens 已知	翻译出错，请更新
messages 已知	翻译出错，请更新
middleaged 已知	翻译出错，请更新
mildly 已知	翻译出错，请更新
mile 已知	翻译出错，请更新
million 已知	翻译出错，请更新
mission 已知	翻译出错，请更新
mistakes 已知	翻译出错，请更新
modesty 已知	翻译出错，请更新
moneys 已知	翻译出错，请更新
mood 已知	翻译出错，请更新
moody 已知	翻译出错，请更新
moral 已知	翻译出错，请更新
mortal 已知	翻译出错，请更新
moth 已知	翻译出错，请更新
motive 已知	翻译出错，请更新
motives 已知	翻译出错，请更新
mule 已知	翻译出错，请更新
mutton 已知	翻译出错，请更新
narrow 已知	翻译出错，请更新
national 已知	翻译出错，请更新
necessities 已知	翻译出错，请更新
negative 已知	翻译出错，请更新
neighbours 已知	翻译出错，请更新
noblemans 已知	翻译出错，请更新
noone 已知	翻译出错，请更新
nostrils 已知	翻译出错，请更新
notions 已知	翻译出错，请更新
notoriety 已知	翻译出错，请更新
novels 已知	翻译出错，请更新
nowhere 已知	翻译出错，请更新
numbers 已知	翻译出错，请更新
obedient 已知	翻译出错，请更新
objected 已知	翻译出错，请更新
observation 已知	翻译出错，请更新
observe 已知	翻译出错，请更新
obstinacy 已知	翻译出错，请更新
obstinate 已知	翻译出错，请更新
odds 已知	翻译出错，请更新
offender 已知	翻译出错，请更新
offensive 已知	翻译出错，请更新
offers 已知	翻译出错，请更新
ogre 已知	翻译出错，请更新
omitted 已知	翻译出错，请更新
oration 已知	翻译出错，请更新
ordeal 已知	翻译出错，请更新
ordered 已知	翻译出错，请更新
orderly 已知	翻译出错，请更新
outer 已知	翻译出错，请更新
overcome 已知	翻译出错，请更新
overtures 已知	翻译出错，请更新
owing 已知	翻译出错，请更新
pace 已知	翻译出错，请更新
pack 已知	翻译出错，请更新
packed 已知	翻译出错，请更新
pages 已知	翻译出错，请更新
pains 已知	翻译出错，请更新
pairs 已知	翻译出错，请更新
paroxysms 已知	翻译出错，请更新
parting 已知	翻译出错，请更新
paths 已知	翻译出错，请更新
peculiarity 已知	翻译出错，请更新
peculiarly 已知	翻译出错，请更新
peerage 已知	翻译出错，请更新
penniless 已知	翻译出错，请更新
per 已知	翻译出错，请更新
perceiving 已知	翻译出错，请更新
perjuries 已知	翻译出错，请更新
permission 已知	翻译出错，请更新
perseverance 已知	翻译出错，请更新
persistent 已知	翻译出错，请更新
pet 已知	翻译出错，请更新
pheasants 已知	翻译出错，请更新
photographs 已知	翻译出错，请更新
picking 已知	翻译出错，请更新
pique 已知	翻译出错，请更新
placing 已知	翻译出错，请更新
planned 已知	翻译出错，请更新
platform 已知	翻译出错，请更新
pleasing 已知	翻译出错，请更新
plight 已知	翻译出错，请更新
pockets 已知	翻译出错，请更新
poetry 已知	翻译出错，请更新
pointed 已知	翻译出错，请更新
polished 已知	翻译出错，请更新
population 已知	翻译出错，请更新
portion 已知	翻译出错，请更新
postpone 已知	翻译出错，请更新
postscript 已知	翻译出错，请更新
poverty 已知	翻译出错，请更新
practically 已知	翻译出错，请更新
practices 已知	翻译出错，请更新
praised 已知	翻译出错，请更新
prayer 已知	翻译出错，请更新
predicted 已知	翻译出错，请更新
prejudiced 已知	翻译出错，请更新
preliminary 已知	翻译出错，请更新
prepare 已知	翻译出错，请更新
presentation 已知	翻译出错，请更新
president 已知	翻译出错，请更新
presumed 已知	翻译出错，请更新
presuming 已知	翻译出错，请更新
prettier 已知	翻译出错，请更新
prettiest 已知	翻译出错，请更新
prettily 已知	翻译出错，请更新
prevailed 已知	翻译出错，请更新
prevented 已知	翻译出错，请更新
previously 已知	翻译出错，请更新
prisoner 已知	翻译出错，请更新
proceeding 已知	翻译出错，请更新
process 已知	翻译出错，请更新
professed 已知	翻译出错，请更新
profound 已知	翻译出错，请更新
profoundly 已知	翻译出错，请更新
prolonged 已知	翻译出错，请更新
promises 已知	翻译出错，请更新
proposing 已知	翻译出错，请更新
prosaic 已知	翻译出错，请更新
prospered 已知	翻译出错，请更新
prosperity 已知	翻译出错，请更新
protest 已知	翻译出错，请更新
proudly 已知	翻译出错，请更新
punctually 已知	翻译出错，请更新
pupils 已知	翻译出错，请更新
pursuit 已知	翻译出错，请更新
pushing 已知	翻译出错，请更新
quarrelling 已知	翻译出错，请更新
quarrels 已知	翻译出错，请更新
quarters 已知	翻译出错，请更新
queen 已知	翻译出错，请更新
quest 已知	翻译出错，请更新
quit 已知	翻译出错，请更新
quote 已知	翻译出错，请更新
radical 已知	翻译出错，请更新
rail 已知	翻译出错，请更新
raillery 已知	翻译出错，请更新
rare 已知	翻译出错，请更新
ravine 已知	翻译出错，请更新
reaching 已知	翻译出错，请更新
readiness 已知	翻译出错，请更新
reasonable 已知	翻译出错，请更新
recognition 已知	翻译出错，请更新
recovered 已知	翻译出错，请更新
recreation 已知	翻译出错，请更新
reduce 已知	翻译出错，请更新
reduced 已知	翻译出错，请更新
referred 已知	翻译出错，请更新
refrained 已知	翻译出错，请更新
regarding 已知	翻译出错，请更新
regiment 已知	翻译出错，请更新
region 已知	翻译出错，请更新
rejoiced 已知	翻译出错，请更新
relent 已知	翻译出错，请更新
remarkable 已知	翻译出错，请更新
remedy 已知	翻译出错，请更新
render 已知	翻译出错，请更新
renew 已知	翻译出错，请更新
rent 已知	翻译出错，请更新
repentance 已知	翻译出错，请更新
reporter 已知	翻译出错，请更新
repose 已知	翻译出错，请更新
represent 已知	翻译出错，请更新
representing 已知	翻译出错，请更新
resolutions 已知	翻译出错，请更新
resources 已知	翻译出错，请更新
respectful 已知	翻译出错，请更新
restrain 已知	翻译出错，请更新
resumed 已知	翻译出错，请更新
retain 已知	翻译出错，请更新
returns 已知	翻译出错，请更新
reverse 已知	翻译出错，请更新
ribbon 已知	翻译出错，请更新
ribbons 已知	翻译出错，请更新
ridden 已知	翻译出错，请更新
ridicule 已知	翻译出错，请更新
rightly 已知	翻译出错，请更新
ring 已知	翻译出错，请更新
roughly 已知	翻译出错，请更新
routine 已知	翻译出错，请更新
royalty 已知	翻译出错，请更新
ruling 已知	翻译出错，请更新
sacred 已知	翻译出错，请更新
safely 已知	翻译出错，请更新
safest 已知	翻译出错，请更新
salutary 已知	翻译出错，请更新
sauntered 已知	翻译出错，请更新
scold 已知	翻译出错，请更新
scolded 已知	翻译出错，请更新
scorched 已知	翻译出错，请更新
scrape 已知	翻译出错，请更新
scruples 已知	翻译出错，请更新
seconded 已知	翻译出错，请更新
section 已知	翻译出错，请更新
secured 已知	翻译出错，请更新
sees 已知	翻译出错，请更新
select 已知	翻译出错，请更新
self 已知	翻译出错，请更新
selfassertion 已知	翻译出错，请更新
senses 已知	翻译出错，请更新
sentiment 已知	翻译出错，请更新
serviceable 已知	翻译出错，请更新
sessions 已知	翻译出错，请更新
setting 已知	翻译出错，请更新
settling 已知	翻译出错，请更新
severity 已知	翻译出错，请更新
shade 已知	翻译出错，请更新
shades 已知	翻译出错，请更新
sheepskinning 已知	翻译出错，请更新
shop 已知	翻译出错，请更新
shrugged 已知	翻译出错，请更新
shutting 已知	翻译出错，请更新
signature 已知	翻译出错，请更新
similar 已知	翻译出错，请更新
sink 已知	翻译出错，请更新
sits 已知	翻译出错，请更新
sixty 已知	翻译出错，请更新
slept 已知	翻译出错，请更新
smiles 已知	翻译出错，请更新
smooth 已知	翻译出错，请更新
softer 已知	翻译出错，请更新
soil 已知	翻译出错，请更新
sojourn 已知	翻译出错，请更新
sold 已知	翻译出错，请更新
sole 已知	翻译出错，请更新
solely 已知	翻译出错，请更新
solitude 已知	翻译出错，请更新
soreness 已知	翻译出错，请更新
sorrows 已知	翻译出错，请更新
spared 已知	翻译出错，请更新
sparkled 已知	翻译出错，请更新
spilt 已知	翻译出错，请更新
spread 已知	翻译出错，请更新
springing 已知	翻译出错，请更新
sprung 已知	翻译出错，请更新
st 已知	翻译出错，请更新
standard 已知	翻译出错，请更新
starting 已知	翻译出错，请更新
statesmen 已知	翻译出错，请更新
steadily 已知	翻译出错，请更新
steal 已知	翻译出错，请更新
sting 已知	翻译出错，请更新
stool 已知	翻译出错，请更新
strangely 已知	翻译出错，请更新
stretched 已知	翻译出错，请更新
stretching 已知	翻译出错，请更新
strict 已知	翻译出错，请更新
strictly 已知	翻译出错，请更新
striking 已知	翻译出错，请更新
strings 已知	翻译出错，请更新
studies 已知	翻译出错，请更新
subjecting 已知	翻译出错，请更新
submissive 已知	翻译出错，请更新
successor 已知	翻译出错，请更新
sufficed 已知	翻译出错，请更新
suggestion 已知	翻译出错，请更新
suitable 已知	翻译出错，请更新
suitors 已知	翻译出错，请更新
suits 已知	翻译出错，请更新
supporting 已知	翻译出错，请更新
surgeon 已知	翻译出错，请更新
surmise 已知	翻译出错，请更新
suspicious 已知	翻译出错，请更新
swanhood 已知	翻译出错，请更新
sweetly 已知	翻译出错，请更新
sweetness 已知	翻译出错，请更新
sword 已知	翻译出错，请更新
tail 已知	翻译出错，请更新
tasks 已知	翻译出错，请更新
tastes 已知	翻译出错，请更新
tempt 已知	翻译出错，请更新
tended 已知	翻译出错，请更新
tenderly 已知	翻译出错，请更新
theirs 已知	翻译出错，请更新
thereby 已知	翻译出错，请更新
theyd 已知	翻译出错，请更新
thither 已知	翻译出错，请更新
thraldom 已知	翻译出错，请更新
threeandtwenty 已知	翻译出错，请更新
tie 已知	翻译出错，请更新
tied 已知	翻译出错，请更新
towns 已知	城镇
toys 已知	玩具
traces 已知	痕迹
trains 已知	火车
travelled 已知	旅行
triumphantly 已知	胜利地
triumphed 已知	胜利
truest 已知	最真实
tumultuous 已知	动荡的
tutor 已知	家教
twitted 已知	嘲笑
type 已知	类型
umbrella 已知	雨伞
uncles 已知	叔叔
uncommon 已知	不寻常
understands 已知	理解
undertaken 已知	承担
unexpected 已知	意外
unfair 已知	不公
unfrequently 已知	不常
unlikely 已知	不太可能
unmanly 已知	不男子气
unnaturally 已知	不自然
unsatisfactory 已知	不满意
uphill 已知	上坡
upper 已知	上层
upshot 已知	结果
vanished 已知	消失
verdure 已知	绿意
village 已知	村庄
visiting 已知	拜访
vital 已知	重要的
waking 已知	醒来
warning 已知	警告
waste 已知	浪费
weaknesses 已知	弱点
weather 已知	天气
weep 已知	哭泣
weighed 已知	称重
weve 已知	我们有
whenever 已知	每当
wig 已知	假发
wiped 已知	擦拭
womanhood 已知	女性
wonderfully 已知	精彩地
wondering 已知	想知道
writs 已知	令状
Abbey 已知	翻译出错，请更新
Acre 已知	翻译出错，请更新
Affairs 已知	翻译出错，请更新
Afterwards 已知	翻译出错，请更新
Alison 已知	翻译出错，请更新
Allow 已知	翻译出错，请更新
Almost 已知	翻译出错，请更新
Angry 已知	翻译出错，请更新
Anything 已知	翻译出错，请更新
Athenaeum 已知	翻译出错，请更新
AttorneyGeneral 已知	翻译出错，请更新
Austrian 已知	翻译出错，请更新
BRENTFORD 已知	翻译出错，请更新
Bath 已知	翻译出错，请更新
Behind 已知	翻译出错，请更新
Birmingham 已知	翻译出错，请更新
Bishop 已知	翻译出错，请更新
Blake 已知	翻译出错，请更新
Blane 已知	翻译出错，请更新
Blink 已知	翻译出错，请更新
Braes 已知	翻译出错，请更新
Britain 已知	翻译出错，请更新
Brock 已知	翻译出错，请更新
Broderick 已知	翻译出错，请更新
Bromwich 已知	翻译出错，请更新
Brook 已知	翻译出错，请更新
Burke 已知	翻译出错，请更新
Call 已知	翻译出错，请更新
Canadas 已知	翻译出错，请更新
Cannings 已知	翻译出错，请更新
Cantrips 已知	翻译出错，请更新
Carey 已知	翻译出错，请更新
Carlton 已知	翻译出错，请更新
Catholics 已知	翻译出错，请更新
Chambers 已知	翻译出错，请更新
Chancellors 已知	翻译出错，请更新
Chateau 已知	翻译出错，请更新
Children 已知	翻译出错，请更新
Claddagh 已知	翻译出错，请更新
Clause 已知	翻译出错，请更新
Conachar 已知	翻译出错，请更新
Connaught 已知	翻译出错，请更新
Cork 已知	翻译出错，请更新
Corpus 已知	翻译出错，请更新
Cottesmore 已知	翻译出错，请更新
Count 已知	翻译出错，请更新
Covent 已知	翻译出错，请更新
Crichton 已知	翻译出错，请更新
Cross 已知	翻译出错，请更新
DUKE 已知	翻译出错，请更新
Damn 已知	翻译出错，请更新
Darby 已知	翻译出错，请更新
Dick 已知	翻译出错，请更新
Doubtless 已知	翻译出错，请更新
Dresden 已知	翻译出错，请更新
Dubby 已知	翻译出错，请更新
Each 已知	翻译出错，请更新
Enough 已知	翻译出错，请更新
Eton 已知	翻译出错，请更新
Eve 已知	翻译出错，请更新
Ever 已知	翻译出错，请更新
Explain 已知	翻译出错，请更新
Fiddlestick 已知	翻译出错，请更新
Flanders 已知	翻译出错，请更新
Frank 已知	翻译出错，请更新
GOESLER 已知	翻译出错，请更新
Gamaliels 已知	翻译出错，请更新
Garden 已知	翻译出错，请更新
Garter 已知	翻译出错，请更新
Gentlemen 已知	翻译出错，请更新
Germany 已知	翻译出错，请更新
Giless 已知	翻译出错，请更新
Given 已知	翻译出错，请更新
Greek 已知	翻译出错，请更新
Greeswing 已知	翻译出错，请更新
Gregory 已知	翻译出错，请更新
Habeas 已知	翻译出错，请更新
Halloa 已知	翻译出错，请更新
Hard 已知	翻译出错，请更新
Headache 已知	翻译出错，请更新
Help 已知	翻译出错，请更新
Herr 已知	翻译出错，请更新
Highness 已知	翻译出错，请更新
Hill 已知	翻译出错，请更新
Horse 已知	翻译出错，请更新
Indian 已知	翻译出错，请更新
Inns 已知	翻译出错，请更新
Jane 已知	翻译出错，请更新
Joan 已知	翻译出错，请更新
Jove 已知	翻译出错，请更新
Keep 已知	翻译出错，请更新
Kilfenora 已知	翻译出错，请更新
Killaloeians 已知	翻译出错，请更新
Kingstown 已知	翻译出错，请更新
L 已知	翻译出错，请更新
Lapoule 已知	翻译出错，请更新
Later 已知	翻译出错，请更新
Latterly 已知	翻译出错，请更新
Leicestershire 已知	翻译出错，请更新
Liberalism 已知	翻译出错，请更新
Long 已知	翻译出错，请更新
Longroyston 已知	翻译出错，请更新
Lucifer 已知	翻译出错，请更新
MAX 已知	翻译出错，请更新
Manchester 已知	翻译出错，请更新
Margin 已知	翻译出错，请更新
Mariana 已知	翻译出错，请更新
Maybe 已知	翻译出错，请更新
Means 已知	翻译出错，请更新
Merrilies 已知	翻译出错，请更新
Mill 已知	翻译出错，请更新
Mockrath 已知	翻译出错，请更新
Moll 已知	翻译出错，请更新
Molonys 已知	翻译出错，请更新
Monument 已知	翻译出错，请更新
More 已知	翻译出错，请更新
Mottram 已知	翻译出错，请更新
Mount 已知	翻译出错，请更新
Mountains 已知	翻译出错，请更新
Munster 已知	翻译出错，请更新
Must 已知	翻译出错，请更新
Nature 已知	翻译出错，请更新
North 已知	翻译出错，请更新
O 已知	翻译出错，请更新
Ought 已知	翻译出错，请更新
P 已知	翻译出错，请更新
Palmerston 已知	翻译出错，请更新
Patronage 已知	翻译出错，请更新
Pay 已知	翻译出错，请更新
Persse 已知	翻译出错，请更新
Perthshire 已知	翻译出错，请更新
Peter 已知	翻译出错，请更新
Peterborough 已知	翻译出错，请更新
Philistine 已知	翻译出错，请更新
Phin 已知	翻译出错，请更新
Pickwell 已知	翻译出错，请更新
Pitt 已知	翻译出错，请更新
Political 已知	翻译出错，请更新
Pope 已知	翻译出错，请更新
Pouncefoots 已知	翻译出错，请更新
Presently 已知	翻译出错，请更新
Pretty 已知	翻译出错，请更新
Primrose 已知	翻译出错，请更新
Puck 已知	翻译出错，请更新
Railway 已知	翻译出错，请更新
Really 已知	翻译出错，请更新
Red 已知	翻译出错，请更新
Redistribution 已知	翻译出错，请更新
Regents 已知	翻译出错，请更新
Resign 已知	翻译出错，请更新
Respecting 已知	翻译出错，请更新
Romford 已知	翻译出错，请更新
Room 已知	翻译出错，请更新
Royal 已知	翻译出错，请更新
Sabbath 已知	翻译出错，请更新
Sancho 已知	翻译出错，请更新
September 已知	翻译出错，请更新
Seven 已知	翻译出错，请更新
Seventeen 已知	翻译出错，请更新
Showing 已知	翻译出错，请更新
Sit 已知	翻译出错，请更新
Soho 已知	翻译出错，请更新
Someone 已知	翻译出错，请更新
Somerby 已知	翻译出错，请更新
Standishes 已知	翻译出错，请更新
Surely 已知	翻译出错，请更新
Switzerland 已知	翻译出错，请更新
Talk 已知	翻译出错，请更新
Terriers 已知	翻译出错，请更新
Thereupon 已知	翻译出错，请更新
Theyll 已知	翻译出错，请更新
Theyre 已知	翻译出错，请更新
Theyve 已知	翻译出错，请更新
Thistle 已知	翻译出错，请更新
Till 已知	翻译出错，请更新
Tipperary 已知	翻译出错，请更新
Tories 已知	翻译出错，请更新
Touching 已知	翻译出错，请更新
Troubles 已知	翻译出错，请更新
Try 已知	翻译出错，请更新
Under 已知	翻译出错，请更新
Undoubtedly 已知	翻译出错，请更新
Upper 已知	翻译出错，请更新
Utopia 已知	翻译出错，请更新
Vellums 已知	翻译出错，请更新
Victoria 已知	翻译出错，请更新
Viscount 已知	翻译出错，请更新
Ways 已知	翻译出错，请更新
Wednesdays 已知	翻译出错，请更新
Whereupon 已知	翻译出错，请更新
White 已知	翻译出错，请更新
Whitehall 已知	翻译出错，请更新
Without 已知	翻译出错，请更新
Wont 已知	翻译出错，请更新
Wouldnt 已知	翻译出错，请更新
Write 已知	翻译出错，请更新
Yorks 已知	翻译出错，请更新
Young 已知	翻译出错，请更新
Yquem 已知	翻译出错，请更新
Zoo 已知	翻译出错，请更新
abolition 已知	废除
abominable 已知	令人厌恶
absenting 已知	缺席
abused 未知	滥用
acceptable 未知	可接受
accommodate 未知	适应
accorded 未知	授予
accordingly 未知	因此
actors 未知	演员
acts 未知	行动
actuated 未知	驱动
adding 未知	添加
additional 未知	附加的
adequate 未知	足够的
adhesion 未知	粘附
adieu 未知	再见
adjournment 未知	休会
administered 未知	管理
admission 未知	允许
admittance 未知	准入
adventures 未知	冒险
adventuress 未知	女冒险家
adversaries 未知	对手
advocated 未知	倡导
affect 未知	影响
affectation 未知	做作
affectionately 未知	深情地
afternoons 未知	下午
aged 未知	老化
aid 未知	援助
ailment 未知	疾病
ails 未知	痛苦
akimbo 未知	双手叉腰
alert 未知	警觉
alike 未知	相似
allegiance 未知	忠诚
allusions 未知	典故
aloft 未知	在高处
aloud 未知	大声
alter 未知	改变
amazement 未知	惊讶
amazingly 未知	令人惊讶
ambassador 未知	大使
amenable 未知	顺从的
amenities 未知	便利设施
ample 未知	足够的
angel 未知	天使
animation 未知	动画
announcements 未知	公告
annoyance 未知	恼怒
annual 未知	每年的
annum 未知	年
antagonism 未知	对立
antagonist 未知	对手
anticipation 未知	预期
apparel 未知	服装
appeal 未知	吸引
appearing 未知	出现
appertaining 未知	相关的
applause 未知	鼓掌
applications 未知	申请
appointed 未知	任命
appointments 未知	约会
apron 未知	围裙
aptitude 未知	天赋
arbitrary 未知	任意的
ardour 未知	热情
arena 未知	圆形竞技场
arise 未知	出现
arrive 未知	到达
artisans 未知	工匠
artist 未知	艺术家
arts 未知	艺术
ashes 未知	灰烬
asis 未知	如此
aspect 未知	方面
aspirant 未知	有志者
assertions 未知	断言
associate 未知	关联
association 未知	协会
astounded 未知	震惊
asylum 未知	庇护所
attachment 未知	附件
attending 未知	参加
auburn 未知	赤褐色
avenged 未知	复仇
averse 未知	反感
avoiding 未知	避免
awake 未知	醒来
bachelor 未知	学士
backed 未知	支持
backwards 未知	向后
badger 未知	獾
balance 未知	平衡
balderdash 未知	胡说
banish 未知	驱逐
banishment 未知	放逐
banks 未知	银行
bare 未知	光秃
barren 未知	贫瘠
batch 未知	一批
bathchair 未知	浴椅
bauble 未知	球饰
bearing 未知	具有
beavers 未知	海狸
bedad 未知	我的天
beds 未知	床
bedside 未知	床边
bee 未知	蜜蜂
beginner 未知	初学者
behave 未知	举止
behoved 未知	适合
behoves 未知	适合
beings 未知	生物
belongings 未知	财物
beloved 未知	心爱
beneficent 未知	慈善的
bestow 未知	赠予
betake 未知	去
bets 未知	赌注
betters 未知	改善
bewildered 未知	困惑
bids 未知	出价
billing 未知	开账单
biting 未知	咬
blackbrowed 未知	黑眉
blamed 未知	责备
blaming 未知	责怪
blandest 未知	最平淡
blazoned 未知	纹章
blessing 未知	祝福
blessings 未知	祝福
bliss 未知	幸福
blowing 未知	吹
blows 未知	打击
blunder 未知	错误
boards 未知	板子
boasting 未知	吹牛
boats 未知	船
bodies 未知	身体
boldly 未知	大胆
bondage 未知	奴役
bonnet 未知	帽子
boon 未知	恩惠
borders 未知	边界
bower 未知	亭子
bows 未知	鞠躬
box 未知	盒子
brave 未知	勇敢
breasts 未知	胸部
brethren 未知	兄弟
brewing 未知	酿造
bridal 未知	婚礼的
brighter 未知	更明亮
broader 未知	更广泛
brokenhearted 未知	伤心
brooch 未知	胸针
brooks 未知	小溪
brotherhood 未知	兄弟会
brushing 未知	刷
buckled 未知	扣紧
bugbear 未知	令人恐惧的事物
build 未知	建造
buildings 未知	建筑物
buried 未知	埋藏
burned 未知	烧毁
burst 未知	爆裂
butler 未知	管家
buys 未知	购买
buzzing 未知	嗡嗡声
bygones 未知	过去的事情
cabined 未知	关闭
cabinets 未知	橱柜
cage 未知	笼子
cake 未知	蛋糕
cakes 未知	蛋糕
calculate 未知	计算
calculations 未知	计算
callers 未知	来电者
calmly 未知	冷静地
candle 未知	蜡烛
canvassed 未知	审视
careers 未知	职业
cases 未知	案件
casting 未知	投掷
catastrophe 未知	灾难
caused 未知	导致
causes 未知	原因
cavalier 未知	骑士
ceasing 未知	停止
century 未知	世纪
chain 未知	链
chalk 未知	粉笔
champion 未知	冠军
chary 未知	小心
cheaper 未知	更便宜
cheese 未知	奶酪
childish 未知	幼稚
chivalric 未知	骑士的
chivalry 未知	骑士精神
choicest 未知	最优质
choosing 未知	选择
chucked 未知	翻译出错，请更新
circle 未知	翻译出错，请更新
circumspect 未知	翻译出错，请更新
circumstance 未知	翻译出错，请更新
citizen 未知	翻译出错，请更新
claimed 未知	翻译出错，请更新
claims 未知	翻译出错，请更新
clamour 未知	翻译出错，请更新
classes 未知	翻译出错，请更新
clay 未知	翻译出错，请更新
climbing 未知	翻译出错，请更新
clipping 未知	翻译出错，请更新
closet 未知	翻译出错，请更新
clouds 未知	翻译出错，请更新
clung 未知	翻译出错，请更新
coalheaver 未知	翻译出错，请更新
coatpocket 未知	翻译出错，请更新
coats 未知	翻译出错，请更新
coerced 未知	翻译出错，请更新
collapsed 未知	翻译出错，请更新
colours 未知	翻译出错，请更新
comers 未知	翻译出错，请更新
commence 未知	翻译出错，请更新
commencing 未知	翻译出错，请更新
commerce 未知	翻译出错，请更新
committing 未知	翻译出错，请更新
commonly 未知	翻译出错，请更新
commotion 未知	翻译出错，请更新
communicated 未知	翻译出错，请更新
comparatively 未知	翻译出错，请更新
compass 未知	翻译出错，请更新
complained 未知	翻译出错，请更新
complaint 未知	翻译出错，请更新
composure 未知	翻译出错，请更新
comprehend 未知	翻译出错，请更新
compulsory 未知	翻译出错，请更新
conceded 未知	翻译出错，请更新
concerns 未知	翻译出错，请更新
concert 未知	翻译出错，请更新
concession 未知	翻译出错，请更新
concluding 未知	翻译出错，请更新
condescension 未知	翻译出错，请更新
conditions 未知	翻译出错，请更新
condolements 未知	翻译出错，请更新
confer 未知	翻译出错，请更新
conferences 未知	翻译出错，请更新
confession 未知	翻译出错，请更新
conformity 未知	翻译出错，请更新
confounded 未知	翻译出错，请更新
congratulating 未知	翻译出错，请更新
conjugal 未知	翻译出错，请更新
conquering 未知	翻译出错，请更新
conscientious 未知	翻译出错，请更新
consequently 未知	翻译出错，请更新
conservatories 未知	翻译出错，请更新
consoled 未知	翻译出错，请更新
constituents 未知	翻译出错，请更新
constitutional 未知	翻译出错，请更新
constructed 未知	翻译出错，请更新
consult 未知	翻译出错，请更新
contaminated 未知	翻译出错，请更新
contests 未知	翻译出错，请更新
continual 未知	翻译出错，请更新
continuing 未知	翻译出错，请更新
contradict 未知	翻译出错，请更新
contradicting 未知	翻译出错，请更新
convened 未知	翻译出错，请更新
convert 未知	翻译出错，请更新
convincing 未知	翻译出错，请更新
cooing 未知	翻译出错，请更新
copy 未知	翻译出错，请更新
copybook 未知	翻译出错，请更新
copying 未知	翻译出错，请更新
correct 未知	翻译出错，请更新
costly 未知	翻译出错，请更新
costs 未知	翻译出错，请更新
costume 未知	翻译出错，请更新
councils 未知	翻译出错，请更新
counter 未知	翻译出错，请更新
countess 未知	翻译出错，请更新
countries 未知	翻译出错，请更新
countryman 未知	翻译出错，请更新
courtship 未知	翻译出错，请更新
cousins 未知	翻译出错，请更新
coveted 未知	翻译出错，请更新
cowed 未知	翻译出错，请更新
cows 未知	翻译出错，请更新
coy 未知	翻译出错，请更新
crammed 未知	翻译出错，请更新
creditable 未知	翻译出错，请更新
creep 未知	翻译出错，请更新
crept 未知	翻译出错，请更新
cribbed 未知	翻译出错，请更新
criticising 未知	翻译出错，请更新
crossing 未知	翻译出错，请更新
crossquestioning 未知	翻译出错，请更新
crotchety 未知	翻译出错，请更新
crowding 未知	翻译出错，请更新
crowds 未知	翻译出错，请更新
cruelly 未知	翻译出错，请更新
cruelties 未知	翻译出错，请更新
culling 未知	剔除
cup 未知	杯子
cupboard 未知	橱柜
curious 未知	好奇的
curl 未知	卷曲
current 未知	当前的
daggers 未知	匕首
damp 未知	潮湿的
dancers 未知	舞者
dancing 未知	舞蹈
dangers 未知	危险
dangling 未知	悬挂的
dawn 未知	黎明
deadly 未知	致命的
debated 未知	争论的
debaters 未知	辩论者
debtor 未知	债务人
decked 未知	装饰的
declining 未知	下降的
deeds 未知	行为
defalcation 未知	侵占
defaulters 未知	拖欠者
defended 未知	防御的
defending 未知	辩护
defined 未知	确定的
degradation 未知	降级
degraded 未知	退化的
deliberation 未知	深思熟虑
delicious 未知	美味的
delightfully 未知	令人愉快地
demagogue 未知	煽动者
demagogues 未知	煽动者（复数）
democracy 未知	民主
demonstrations 未知	示威
departed 未知	逝去的
depended 未知	依赖的
deprive 未知	剥夺
deserves 未知	应得
destination 未知	目的地
details 未知	细节
detain 未知	拘留
dictation 未知	听写
dimness 未知	昏暗
dimple 未知	酒窝
dines 未知	用餐
dinnerparties 未知	晚宴
disagree 未知	不同意
disappear 未知	消失
discomfited 未知	使困惑
discomfiture 未知	困惑
discontented 未知	不满的
discouraged 未知	灰心的
discredit 未知	失去信誉
discreditable 未知	不光彩的
disfranchise 未知	剥夺选举权
dishes 未知	菜肴
disobeying 未知	违抗
disparaging 未知	贬低的
disposition 未知	性情
dispute 未知	争论
disregard 未知	忽视
dissatisfaction 未知	不满
dissented 未知	不同意
distinct 未知	明显的
distinction 未知	区别
distress 未知	痛苦
distressed 未知	痛苦的
districts 未知	区域
doctrines 未知	教义
dogs 未知	狗
domestic 未知	国内的
domineer 未知	专横
dominion 未知	统治
donkey 未知	驴
doorway 未知	门口
doting 未知	溺爱的
doubled 未知	加倍的
doubledangerous 未知	双重危险的
doubts 未知	怀疑
drag 未知	拖动
dreadfully 未知	可怕地
dressinggown 未知	睡袍
dried 未知	干燥的
drifted 未知	漂流的
drinks 未知	饮料
drone 未知	嗡嗡声
drops 未知	水滴
drove 未知	驾驶
drunkard 未知	酒鬼
drunkards 未知	酒鬼（复数）
duchesses 未知	公爵夫人
duck 未知	鸭子
duelling 未知	决斗
dug 未知	挖掘
dukedom 未知	公爵的地位
duplicity 未知	二重性
dwelt 未知	居住
eagerly 未知	渴望地
earl 未知	伯爵
earthquake 未知	地震
east 未知	东
eavy 未知	负担
economy 未知	经济
efficacious 未知	有效的
eggs 未知	鸡蛋
ejaculated 未知	喷射
elapsed 未知	经过
elders 未知	长者
eldest 未知	最年长的
elector 未知	选民
element 未知	元素
emergency 未知	紧急情况
emigrate 未知	移民
employ 未知	雇佣
emptied 未知	清空
enclosure 未知	附件
endorsed 未知	认可的
endowed 未知	赋予
ends 未知	结束
endurance 未知	耐力
enduring 未知	持久的
enemys 未知	敌人（复数）
energetically 未知	精力充沛地
enfranchisement 未知	选举权
enhanced 未知	增强的
ensconced 未知	隐藏的
enterprise 未知	企业
entertaining 未知	娱乐
entertainment 未知	娱乐活动
entrusted 未知	委托
envious 未知	嫉妒的
episode 未知	插曲
equality 未知	平等
equalled 未知	等于
erroneous 未知	错误的
essentially 未知	本质上
establish 未知	建立
estranged 未知	疏远的
eulogist 未知	颂扬者
everyone 未知	每个人
evident 未知	明显的
exalted 未知	崇高的
examined 未知	检查过的
exceeded 未知	超过
excel 未知	出色
excepting 未知	除了
excess 未知	过量
exchange 未知	交换
execution 未知	执行
exigencies 未知	紧急情况（复数）
exit 未知	退出
expectation 未知	期望
expelled 未知	驱逐
expenditure 未知	支出
expenses 未知	开支
explanation 未知	解释
expressive 未知	表达的
exquisite 未知	精美的
extensive 未知	广泛的
external 未知	外部的
extract 未知	提取
faction 未知	派系
faithful 未知	忠诚的
faltered 未知	颤抖的
familiarity 未知	熟悉
faraway 未知	遥远的
fashionable 未知	时尚的
fastened 未知	系紧的
fat 未知	胖的
features 未知	特征
fertility 未知	生育能力
fervour 未知	热情
fetch 未知	取来
fetching 未知	迷人的
fickle 未知	易变的
fiction 未知	虚构
fierce 未知	凶猛的
fieryred 未知	火红的
figures 未知	数字
filling 未知	填充
finally 未知	最终
finer 未知	更细的
finger 未知	手指
finishing 未知	完成
fired 未知	被解雇
fishing 未知	钓鱼
fists 未知	拳头
fiveandtwenty 未知	二十五
flashed 未知	闪光
fling 未知	投掷
flirt 未知	调情
flirting 未知	调情（进行时）
floor 未知	地板
flown 未知	飞行
flung 未知	投掷
flutter 未知	颤动
fluttering 未知	颤动（进行时）
folly 未知	愚蠢
fondly 未知	深情地
foolhardy 未知	鲁莽的
footmen 未知	随员
forbade 未知	禁止
forbid 未知	禁止
forebodings 未知	不祥的预感
forgetting 未知	忘记
forthcoming 未知	即将到来的
founded 未知	创立
fourteen 未知	十四
frame 未知	框架
frankly 未知	坦率地
fraud 未知	欺诈
freed 未知	解放
freethinking 未知	自由思想
frequent 未知	频繁的
frequented 未知	经常光顾的
friendships 未知	友谊
frightfully 未知	可怕地
frowning 未知	皱眉
fruits 未知	水果
funds 未知	资金
furnished 未知	配备的
furthest 未知	最远的
gains 未知	收益
gambling 未知	赌博
gammon 未知	诱惑
garment 未知	衣服
gate 未知	大门
gateway 未知	入口
gazed 未知	凝视
gem 未知	宝石
generalities 未知	一般性
genial 未知	友好的
genleman 未知	绅士
gentlemens 未知	绅士（复数）
genuine 未知	真实的
gesture 未知	手势
gestures 未知	手势（复数）
gist 未知	要点
glaciers 未知	冰川
gladly 未知	愉快地
glasses 未知	眼镜
glided 未知	滑行
gloom 未知	忧郁
glove 未知	手套
glowed 未知	发光
glowing 未知	发光的
golden 未知	黄金的
goodness 未知	善良
gorse 未知	荆棘
gossip 未知	八卦
governments 未知	政府
governor 未知	州长
governors 未知	州长（复数）
grandees 未知	贵族
grandmother 未知	祖母
grievance 未知	不满
grievances 未知	不满（复数）
griffin 未知	狮鹫
groaned 未知	呻吟
grooves 未知	沟槽
gross 未知	总体的
grownup 未知	成年人
grunt 未知	嗥叫
guarantee 未知	保证
guardian 未知	监护人
guarding 未知	保护
guessed 未知	猜测
guide 未知	导游
guinea 未知	基尼
guns 未知	枪
ha 未知	哈
halfbarbarous 未知	半野蛮的
handkerchief 未知	手帕
handle 未知	处理
handsomest 未知	最英俊的
handwriting 未知	手写
harassing 未知	骚扰
hardest 未知	最难的
hark 未知	听
hateful 未知	令人厌恶的
haunt 未知	萦绕
hay 未知	干草
heading 未知	标题
headings 未知	标题（复数）
heap 未知	一堆
heaps 未知	大量
heavily 未知	沉重地
heel 未知	脚后跟
heiresses 未知	女继承人
helping 未知	帮助
helpless 未知	无助的
hence 未知	因此
henceforth 未知	从今往后
heretofore 未知	迄今为止
hermits 未知	隐士
highminded 未知	高尚的
highnesses 未知	高贵的
highprincipled 未知	高原则的
hinder 未知	阻碍
hints 未知	暗示
hire 未知	雇用
hoarsely 未知	沙哑地
hobble 未知	蹒跚
holds 未知	握住
hole 未知	孔
holes 未知	孔（复数）
holidays 未知	假期
homes 未知	家
honester 未知	更诚实的
hopelessly 未知	绝望地
horseman 未知	骑马者
hostility 未知	敌意
hotel 未知	酒店
hotter 未知	更热的
hound 未知	狗
houri 未知	仙女
housekeeper 未知	女管家
hovering 未知	悬停
humdrum 未知	单调的
humoured 未知	有幽默感的
hurting 未知	受伤
hypocrisy 未知	伪善
identical 未知	相同的
identity 未知	身份
idiot 未知	翻译出错，请更新
ignominy 未知	翻译出错，请更新
ignore 未知	翻译出错，请更新
ignored 未知	翻译出错，请更新
illusage 未知	翻译出错，请更新
illustration 未知	翻译出错，请更新
illustrations 未知	翻译出错，请更新
illwill 未知	翻译出错，请更新
im 未知	我是
imbecility 未知	翻译出错，请更新
immense 未知	翻译出错，请更新
imparted 未知	翻译出错，请更新
impeded 未知	翻译出错，请更新
impediments 未知	翻译出错，请更新
imperious 未知	翻译出错，请更新
impervious 未知	翻译出错，请更新
impetuously 未知	翻译出错，请更新
implicitly 未知	翻译出错，请更新
implied 未知	翻译出错，请更新
implore 未知	翻译出错，请更新
imply 未知	翻译出错，请更新
imposed 未知	翻译出错，请更新
impossibility 未知	翻译出错，请更新
impostor 未知	翻译出错，请更新
impressed 未知	翻译出错，请更新
imprisoned 未知	翻译出错，请更新
improbably 未知	翻译出错，请更新
improved 未知	翻译出错，请更新
impudence 未知	翻译出错，请更新
inability 未知	翻译出错，请更新
inaccuracy 未知	翻译出错，请更新
incapable 未知	翻译出错，请更新
inch 未知	翻译出错，请更新
incident 未知	翻译出错，请更新
incidental 未知	翻译出错，请更新
include 未知	翻译出错，请更新
incompatible 未知	翻译出错，请更新
inconstancy 未知	翻译出错，请更新
incurred 未知	翻译出错，请更新
indecent 未知	翻译出错，请更新
indignation 未知	翻译出错，请更新
indiscretion 未知	翻译出错，请更新
inexpressible 未知	翻译出错，请更新
inferior 未知	翻译出错，请更新
infirm 未知	翻译出错，请更新
inflict 未知	翻译出错，请更新
inform 未知	翻译出错，请更新
informants 未知	翻译出错，请更新
informing 未知	翻译出错，请更新
iniquities 未知	翻译出错，请更新
inner 未知	翻译出错，请更新
inquire 未知	翻译出错，请更新
insert 未知	翻译出错，请更新
insignificant 未知	翻译出错，请更新
inspired 未知	翻译出错，请更新
instigated 未知	翻译出错，请更新
instigating 未知	翻译出错，请更新
instruct 未知	翻译出错，请更新
instrument 未知	翻译出错，请更新
insuperable 未知	翻译出错，请更新
insupportable 未知	翻译出错，请更新
intelligent 未知	翻译出错，请更新
intense 未知	翻译出错，请更新
intensity 未知	翻译出错，请更新
interrupt 未知	翻译出错，请更新
intervening 未知	翻译出错，请更新
intimidated 未知	翻译出错，请更新
intrigue 未知	翻译出错，请更新
intruder 未知	翻译出错，请更新
invalid 未知	翻译出错，请更新
invented 未知	翻译出错，请更新
inveterate 未知	翻译出错，请更新
inwardly 未知	翻译出错，请更新
irons 未知	翻译出错，请更新
irresistible 未知	翻译出错，请更新
irresolute 未知	翻译出错，请更新
island 未知	翻译出错，请更新
issue 未知	翻译出错，请更新
itll 未知	翻译出错，请更新
jest 未知	翻译出错，请更新
jilt 未知	翻译出错，请更新
joints 未知	翻译出错，请更新
jumble 未知	翻译出错，请更新
jury 未知	翻译出错，请更新
keeps 未知	翻译出错，请更新
kicking 未知	翻译出错，请更新
kinder 未知	翻译出错，请更新
kneel 未知	翻译出错，请更新
knife 未知	翻译出错，请更新
knight 未知	翻译出错，请更新
knit 未知	翻译出错，请更新
laborious 未知	翻译出错，请更新
labours 未知	翻译出错，请更新
lackueys 未知	翻译出错，请更新
laden 未知	翻译出错，请更新
ladyship 未知	翻译出错，请更新
ladyships 未知	翻译出错，请更新
lamps 未知	翻译出错，请更新
lands 未知	翻译出错，请更新
lap 未知	翻译出错，请更新
latterly 未知	近来
lavished 未知	翻译出错，请更新
lawstationer 未知	翻译出错，请更新
lawstationers 未知	翻译出错，请更新
laying 未知	翻译出错，请更新
leadership 未知	翻译出错，请更新
leaned 未知	翻译出错，请更新
learnt 未知	翻译出错，请更新
lease 未知	翻译出错，请更新
leathern 未知	翻译出错，请更新
leaven 未知	翻译出错，请更新
lectures 未知	翻译出错，请更新
leg 未知	翻译出错，请更新
legally 未知	翻译出错，请更新
legislator 未知	翻译出错，请更新
legislators 未知	翻译出错，请更新
lessen 未知	翻译出错，请更新
level 未知	翻译出错，请更新
liable 未知	翻译出错，请更新
lift 未知	翻译出错，请更新
lifting 未知	翻译出错，请更新
lightly 未知	翻译出错，请更新
likeness 未知	翻译出错，请更新
limb 未知	翻译出错，请更新
linen 未知	翻译出错，请更新
lingering 未知	翻译出错，请更新
link 未知	翻译出错，请更新
linked 未知	翻译出错，请更新
lists 未知	翻译出错，请更新
lit 未知	翻译出错，请更新
litigious 未知	翻译出错，请更新
locks 未知	翻译出错，请更新
lodge 未知	翻译出错，请更新
lodged 未知	翻译出错，请更新
longest 未知	翻译出错，请更新
loom 未知	翻译出错，请更新
lordships 未知	翻译出错，请更新
lore 未知	翻译出错，请更新
loses 未知	翻译出错，请更新
lots 未知	翻译出错，请更新
louder 未知	翻译出错，请更新
loveletter 未知	翻译出错，请更新
lovelorn 未知	翻译出错，请更新
luckily 未知	翻译出错，请更新
lumpy 未知	翻译出错，请更新
lunatic 未知	翻译出错，请更新
machine 未知	翻译出错，请更新
madam 未知	翻译出错，请更新
madame 未知	翻译出错，请更新
madman 未知	翻译出错，请更新
mahogany 未知	翻译出错，请更新
maidens 未知	翻译出错，请更新
main 未知	翻译出错，请更新
maintaining 未知	翻译出错，请更新
majestic 未知	翻译出错，请更新
majorities 未知	翻译出错，请更新
makebelieve 未知	翻译出错，请更新
malicious 未知	翻译出错，请更新
malt 未知	翻译出错，请更新
maltreated 未知	翻译出错，请更新
manfully 未知	翻译出错，请更新
manger 未知	翻译出错，请更新
manifest 未知	翻译出错，请更新
manifested 未知	翻译出错，请更新
mankind 未知	翻译出错，请更新
manoeuvres 未知	翻译出错，请更新
mansion 未知	翻译出错，请更新
map 未知	翻译出错，请更新
maps 未知	翻译出错，请更新
martinet 未知	翻译出错，请更新
maternal 未知	翻译出错，请更新
matrimonial 未知	翻译出错，请更新
mature 未知	翻译出错，请更新
meal 未知	翻译出错，请更新
meanest 未知	翻译出错，请更新
meanness 未知	翻译出错，请更新
meanspirited 未知	翻译出错，请更新
measured 未知	翻译出错，请更新
meditated 未知	翻译出错，请更新
meditating 未知	翻译出错，请更新
meek 未知	翻译出错，请更新
meekness 未知	翻译出错，请更新
meets 未知	翻译出错，请更新
meltingpot 未知	翻译出错，请更新
memorable 未知	翻译出错，请更新
memories 未知	翻译出错，请更新
mended 未知	翻译出错，请更新
mental 未知	翻译出错，请更新
merits 未知	翻译出错，请更新
meshes 未知	翻译出错，请更新
methods 未知	翻译出错，请更新
metropolis 未知	翻译出错，请更新
midnight 未知	翻译出错，请更新
military 未知	翻译出错，请更新
minding 未知	翻译出错，请更新
mingled 未知	翻译出错，请更新
minority 未知	翻译出错，请更新
miracle 未知	翻译出错，请更新
miraculous 未知	翻译出错，请更新
mirror 未知	翻译出错，请更新
mirrors 未知	翻译出错，请更新
miseries 未知	翻译出错，请更新
missing 未知	翻译出错，请更新
misunderstood 未知	翻译出错，请更新
mix 未知	翻译出错，请更新
mixture 未知	翻译出错，请更新
model 未知	翻译出错，请更新
modestly 未知	翻译出错，请更新
momentous 未知	翻译出错，请更新
monkeys 未知	翻译出错，请更新
moon 未知	翻译出错，请更新
moonlight 未知	翻译出错，请更新
moor 未知	翻译出错，请更新
mooted 未知	翻译出错，请更新
morality 未知	翻译出错，请更新
morals 未知	翻译出错，请更新
mostly 未知	翻译出错，请更新
motions 未知	翻译出错，请更新
mounting 未知	翻译出错，请更新
multitude 未知	翻译出错，请更新
murdered 未知	翻译出错，请更新
mustnt 未知	翻译出错，请更新
mysteries 未知	翻译出错，请更新
mysterious 未知	翻译出错，请更新
namely 未知	翻译出错，请更新
nastiness 未知	翻译出错，请更新
nations 未知	翻译出错，请更新
necks 未知	翻译出错，请更新
neighbouring 未知	翻译出错，请更新
nest 未知	翻译出错，请更新
nicer 未知	翻译出错，请更新
nicest 未知	翻译出错，请更新
nick 未知	翻译出错，请更新
nightmare 未知	翻译出错，请更新
nod 未知	翻译出错，请更新
noisy 未知	翻译出错，请更新
nominee 未知	翻译出错，请更新
notched 未知	翻译出错，请更新
nothingness 未知	翻译出错，请更新
notion 未知	翻译出错，请更新
notorious 未知	翻译出错，请更新
novelty 未知	翻译出错，请更新
novice 未知	翻译出错，请更新
numerical 未知	翻译出错，请更新
obeying 未知	翻译出错，请更新
obligation 未知	翻译出错，请更新
obnoxious 未知	翻译出错，请更新
observer 未知	翻译出错，请更新
observing 未知	翻译出错，请更新
obtrusive 未知	翻译出错，请更新
occupying 未知	翻译出错，请更新
ocean 未知	翻译出错，请更新
oftener 未知	翻译出错，请更新
oldfashioned 未知	翻译出错，请更新
operation 未知	翻译出错，请更新
oratorical 未知	翻译出错，请更新
outgoing 未知	翻译出错，请更新
ovation 未知	翻译出错，请更新
owning 未知	翻译出错，请更新
ox 未知	翻译出错，请更新
oxen 未知	翻译出错，请更新
pained 未知	翻译出错，请更新
palate 未知	翻译出错，请更新
palpitation 未知	翻译出错，请更新
pang 未知	翻译出错，请更新
paradise 未知	翻译出错，请更新
paraphernalia 未知	翻译出错，请更新
parks 未知	翻译出错，请更新
parlour 未知	翻译出错，请更新
paroxysm 未知	翻译出错，请更新
passes 未知	翻译出错，请更新
passionate 未知	翻译出错，请更新
passions 未知	翻译出错，请更新
patiently 未知	翻译出错，请更新
peccant 未知	翻译出错，请更新
pedestal 未知	翻译出错，请更新
penitent 未知	翻译出错，请更新
perdition 未知	翻译出错，请更新
performances 未知	翻译出错，请更新
performed 未知	翻译出错，请更新
perfume 未知	翻译出错，请更新
permanently 未知	翻译出错，请更新
persecuting 未知	翻译出错，请更新
personalities 未知	翻译出错，请更新
persuaded 未知	翻译出错，请更新
persuasion 未知	翻译出错，请更新
perversity 未知	翻译出错，请更新
petitions 未知	翻译出错，请更新
petting 未知	翻译出错，请更新
pick 未知	翻译出错，请更新
picnic 未知	翻译出错，请更新
pilot 未知	翻译出错，请更新
pint 未知	翻译出错，请更新
pistol 未知	翻译出错，请更新
pistols 未知	翻译出错，请更新
plainest 未知	翻译出错，请更新
plainspoken 未知	翻译出错，请更新
plate 未知	翻译出错，请更新
pleasantest 未知	翻译出错，请更新
pleasurable 未知	翻译出错，请更新
plentiful 未知	翻译出错，请更新
plough 未知	翻译出错，请更新
pluck 未知	翻译出错，请更新
pointblank 未知	翻译出错，请更新
poisoned 未知	翻译出错，请更新
poking 未知	翻译出错，请更新
poles 未知	翻译出错，请更新
pomposity 未知	翻译出错，请更新
port 未知	翻译出错，请更新
porters 未知	翻译出错，请更新
portico 未知	翻译出错，请更新
possessing 未知	翻译出错，请更新
postchaise 未知	翻译出错，请更新
potent 未知	翻译出错，请更新
poured 未知	翻译出错，请更新
practical 未知	翻译出错，请更新
preach 未知	翻译出错，请更新
preached 未知	翻译出错，请更新
preeminently 未知	翻译出错，请更新
prejudices 未知	翻译出错，请更新
premeditated 未知	翻译出错，请更新
preparations 未知	翻译出错，请更新
prescription 未知	翻译出错，请更新
presents 未知	翻译出错，请更新
pressure 未知	翻译出错，请更新
presumptuous 未知	翻译出错，请更新
pretending 未知	翻译出错，请更新
prided 未知	翻译出错，请更新
principal 未知	翻译出错，请更新
print 未知	翻译出错，请更新
prisoners 未知	翻译出错，请更新
privacy 未知	翻译出错，请更新
privileged 未知	翻译出错，请更新
proceeded 未知	翻译出错，请更新
proceedings 未知	翻译出错，请更新
procured 未知	翻译出错，请更新
prodigal 未知	翻译出错，请更新
producing 未知	翻译出错，请更新
proffered 未知	翻译出错，请更新
prominent 未知	翻译出错，请更新
promote 未知	翻译出错，请更新
promoter 未知	翻译出错，请更新
pronounce 未知	翻译出错，请更新
propensity 未知	翻译出错，请更新
prophecies 未知	翻译出错，请更新
proposals 未知	翻译出错，请更新
proprieties 未知	翻译出错，请更新
prosecution 未知	翻译出错，请更新
prosper 未知	翻译出错，请更新
protected 未知	翻译出错，请更新
province 未知	翻译出错，请更新
proving 未知	翻译出错，请更新
provisions 未知	翻译出错，请更新
provoke 未知	翻译出错，请更新
provoking 未知	翻译出错，请更新
prudent 未知	翻译出错，请更新
prudently 未知	翻译出错，请更新
pugnosed 未知	翻译出错，请更新
pundits 未知	翻译出错，请更新
punish 未知	翻译出错，请更新
punished 未知	翻译出错，请更新
purely 未知	翻译出错，请更新
pursue 未知	翻译出错，请更新
push 未知	翻译出错，请更新
pusillanimous 未知	翻译出错，请更新
qualities 未知	翻译出错，请更新
qualms 未知	翻译出错，请更新
questionings 未知	翻译出错，请更新
quicker 未知	翻译出错，请更新
quiescence 未知	翻译出错，请更新
racecourse 未知	翻译出错，请更新
racehorse 未知	翻译出错，请更新
raging 未知	翻译出错，请更新
ranged 未知	翻译出错，请更新
ranks 未知	翻译出错，请更新
rapidly 未知	翻译出错，请更新
rated 未知	翻译出错，请更新
rates 未知	翻译出错，请更新
rational 未知	翻译出错，请更新
raw 未知	翻译出错，请更新
reads 未知	翻译出错，请更新
realised 未知	翻译出错，请更新
realities 未知	翻译出错，请更新
reappearance 未知	翻译出错，请更新
reasoning 未知	翻译出错，请更新
rebelled 未知	翻译出错，请更新
rebukes 未知	翻译出错，请更新
rebuking 未知	翻译出错，请更新
recalled 未知	翻译出错，请更新
reception 未知	翻译出错，请更新
recipient 未知	翻译出错，请更新
reckoned 未知	翻译出错，请更新
recognises 未知	翻译出错，请更新
record 未知	翻译出错，请更新
recorded 未知	翻译出错，请更新
recover 未知	翻译出错，请更新
recurred 未知	翻译出错，请更新
redemption 未知	翻译出错，请更新
redness 未知	翻译出错，请更新
reflection 未知	翻译出错，请更新
reflections 未知	翻译出错，请更新
refolded 未知	翻译出错，请更新
reforming 未知	翻译出错，请更新
registered 未知	翻译出错，请更新
regretting 未知	翻译出错，请更新
rein 未知	翻译出错，请更新
rejoined 未知	翻译出错，请更新
relative 未知	翻译出错，请更新
remembrances 未知	翻译出错，请更新
remind 未知	翻译出错，请更新
remodelling 未知	翻译出错，请更新
remorse 未知	翻译出错，请更新
remote 未知	翻译出错，请更新
remotest 未知	翻译出错，请更新
remunerative 未知	翻译出错，请更新
renewal 未知	翻译出错，请更新
repaid 未知	翻译出错，请更新
repeatedly 未知	翻译出错，请更新
repeating 未知	翻译出错，请更新
repent 未知	翻译出错，请更新
repetition 未知	翻译出错，请更新
represented 未知	翻译出错，请更新
repute 未知	翻译出错，请更新
requirements 未知	翻译出错，请更新
reseat 未知	翻译出错，请更新
resent 未知	翻译出错，请更新
resigns 未知	翻译出错，请更新
resist 未知	翻译出错，请更新
resolute 未知	翻译出错，请更新
respected 未知	翻译出错，请更新
responsible 未知	翻译出错，请更新
restore 未知	翻译出错，请更新
restrained 未知	翻译出错，请更新
reticence 未知	翻译出错，请更新
retire 未知	翻译出错，请更新
retract 未知	翻译出错，请更新
revolted 未知	翻译出错，请更新
revolutionary 未知	翻译出错，请更新
ribs 未知	翻译出错，请更新
riches 未知	翻译出错，请更新
richly 未知	翻译出错，请更新
riddle 未知	翻译出错，请更新
rider 未知	翻译出错，请更新
rigid 未知	翻译出错，请更新
ringlet 未知	翻译出错，请更新
ringlets 未知	翻译出错，请更新
rivals 未知	翻译出错，请更新
rivers 未知	翻译出错，请更新
robbed 未知	翻译出错，请更新
robust 未知	翻译出错，请更新
roll 未知	翻译出错，请更新
roof 未知	翻译出错，请更新
rubbed 未知	翻译出错，请更新
rubies 未知	翻译出错，请更新
rug 未知	翻译出错，请更新
ruinous 未知	翻译出错，请更新
ruled 未知	翻译出错，请更新
runs 未知	翻译出错，请更新
sackcloth 未知	翻译出错，请更新
saddest 未知	翻译出错，请更新
saddle 未知	翻译出错，请更新
sadness 未知	翻译出错，请更新
sail 未知	翻译出错，请更新
salmon 未知	翻译出错，请更新
saloons 未知	翻译出错，请更新
sanction 未知	翻译出错，请更新
satisfactorily 未知	翻译出错，请更新
savage 未知	翻译出错，请更新
savings 未知	翻译出错，请更新
saviour 未知	翻译出错，请更新
scandal 未知	翻译出错，请更新
scenery 未知	翻译出错，请更新
schemes 未知	翻译出错，请更新
scholar 未知	翻译出错，请更新
scornfully 未知	翻译出错，请更新
scowl 未知	翻译出错，请更新
scrambled 未知	翻译出错，请更新
sea 未知	翻译出错，请更新
sealed 未知	翻译出错，请更新
seceded 未知	翻译出错，请更新
seclusion 未知	翻译出错，请更新
secrecy 未知	翻译出错，请更新
sedulously 未知	翻译出错，请更新
seed 未知	翻译出错，请更新
seeking 未知	翻译出错，请更新
selfconfidence 未知	翻译出错，请更新
selfish 未知	翻译出错，请更新
selfreliance 未知	翻译出错，请更新
selfrespect 未知	翻译出错，请更新
semiofficial 未知	翻译出错，请更新
semisocial 未知	翻译出错，请更新
sensitive 未知	翻译出错，请更新
seriousness 未知	翻译出错，请更新
sermons 未知	翻译出错，请更新
serpent 未知	翻译出错，请更新
sets 未知	翻译出错，请更新
settlement 未知	翻译出错，请更新
severest 未知	翻译出错，请更新
shambling 未知	翻译出错，请更新
shamefully 未知	翻译出错，请更新
shed 未知	翻译出错，请更新
shipwrecked 未知	翻译出错，请更新
shires 未知	翻译出错，请更新
shoemaker 未知	翻译出错，请更新
shoots 未知	翻译出错，请更新
shrug 未知	翻译出错，请更新
shuddering 未知	翻译出错，请更新
shuffled 未知	翻译出错，请更新
shy 未知	翻译出错，请更新
siege 未知	翻译出错，请更新
sift 未知	翻译出错，请更新
signed 未知	翻译出错，请更新
signified 未知	翻译出错，请更新
signs 未知	翻译出错，请更新
silenced 未知	翻译出错，请更新
sincerity 未知	翻译出错，请更新
sinful 未知	翻译出错，请更新
sinned 未知	翻译出错，请更新
skies 未知	翻译出错，请更新
sleeves 未知	翻译出错，请更新
slightly 未知	翻译出错，请更新
sling 未知	翻译出错，请更新
slipped 未知	翻译出错，请更新
slippery 未知	翻译出错，请更新
slush 未知	翻译出错，请更新
sly 未知	翻译出错，请更新
smoke 未知	翻译出错，请更新
smoothly 未知	翻译出错，请更新
snaffle 未知	翻译出错，请更新
snatched 未知	翻译出错，请更新
snatches 未知	翻译出错，请更新
snow 未知	翻译出错，请更新
snub 未知	翻译出错，请更新
snubbed 未知	翻译出错，请更新
snuff 未知	翻译出错，请更新
snug 未知	翻译出错，请更新
socalled 未知	翻译出错，请更新
socially 未知	翻译出错，请更新
softened 未知	翻译出错，请更新
softest 未知	翻译出错，请更新
softly 未知	翻译出错，请更新
soiled 未知	翻译出错，请更新
solemnly 未知	翻译出错，请更新
somehow 未知	翻译出错，请更新
songs 未知	翻译出错，请更新
soninlaw 未知	翻译出错，请更新
sought 未知	翻译出错，请更新
sounds 未知	翻译出错，请更新
soup 未知	翻译出错，请更新
sovereign 未知	翻译出错，请更新
spare 未知	翻译出错，请更新
sparks 未知	翻译出错，请更新
sparring 未知	翻译出错，请更新
speaks 未知	翻译出错，请更新
speculated 未知	翻译出错，请更新
speedy 未知	翻译出错，请更新
spends 未知	翻译出错，请更新
sport 未知	翻译出错，请更新
sporting 未知	翻译出错，请更新
springs 未知	翻译出错，请更新
sprinkled 未知	翻译出错，请更新
stables 未知	翻译出错，请更新
staff 未知	翻译出错，请更新
stag 未知	翻译出错，请更新
staircase 未知	翻译出错，请更新
staircases 未知	翻译出错，请更新
star 未知	翻译出错，请更新
startling 未知	翻译出错，请更新
statecraft 未知	翻译出错，请更新
stately 未知	翻译出错，请更新
statistics 未知	翻译出错，请更新
stead 未知	翻译出错，请更新
steamer 未知	翻译出错，请更新
stepping 未知	翻译出错，请更新
stiffness 未知	翻译出错，请更新
stir 未知	翻译出错，请更新
stoop 未知	翻译出错，请更新
strangled 未知	翻译出错，请更新
strategy 未知	翻译出错，请更新
strayed 未知	翻译出错，请更新
striven 未知	翻译出错，请更新
strode 未知	翻译出错，请更新
strolled 未知	翻译出错，请更新
strongest 未知	翻译出错，请更新
struggled 未知	翻译出错，请更新
struggling 未知	翻译出错，请更新
stumbled 未知	翻译出错，请更新
stumbling 未知	翻译出错，请更新
style 未知	翻译出错，请更新
subaltern 未知	翻译出错，请更新
subjection 未知	翻译出错，请更新
submitting 未知	翻译出错，请更新
succeeding 未知	翻译出错，请更新
suddenness 未知	翻译出错，请更新
sufferer 未知	翻译出错，请更新
suffice 未知	翻译出错，请更新
suggest 未知	翻译出错，请更新
superior 未知	翻译出错，请更新
surpassed 未知	翻译出错，请更新
surprising 未知	翻译出错，请更新
surrender 未知	翻译出错，请更新
surrendered 未知	翻译出错，请更新
suspect 未知	翻译出错，请更新
swallow 未知	翻译出错，请更新
sympathise 未知	翻译出错，请更新
sympathising 未知	翻译出错，请更新
tactics 未知	翻译出错，请更新
talent 未知	翻译出错，请更新
talkative 未知	翻译出错，请更新
taller 未知	翻译出错，请更新
tallow 未知	翻译出错，请更新
tantamount 未知	翻译出错，请更新
tantrums 未知	翻译出错，请更新
team 未知	翻译出错，请更新
technicalities 未知	翻译出错，请更新
tedium 未知	翻译出错，请更新
telegraphed 未知	翻译出错，请更新
temporary 未知	翻译出错，请更新
tempter 未知	翻译出错，请更新
tenpound 未知	翻译出错，请更新
tent 未知	翻译出错，请更新
tenth 未知	翻译出错，请更新
tents 未知	翻译出错，请更新
termination 未知	翻译出错，请更新
terror 未知	翻译出错，请更新
thankful 未知	翻译出错，请更新
thanking 未知	翻译出错，请更新
thickness 未知	翻译出错，请更新
thinskinned 未知	翻译出错，请更新
thong 未知	翻译出错，请更新
thorn 未知	翻译出错，请更新
thoroughgoing 未知	翻译出错，请更新
thoughtfulness 未知	翻译出错，请更新
thoughtlessness 未知	翻译出错，请更新
threaten 未知	翻译出错，请更新
thrice 未知	翻译出错，请更新
throb 未知	翻译出错，请更新
throng 未知	翻译出错，请更新
throttled 未知	翻译出错，请更新
throubles 未知	翻译出错，请更新
thunder 未知	翻译出错，请更新
thundered 未知	翻译出错，请更新
ticket 未知	翻译出错，请更新
ties 未知	翻译出错，请更新
titled 未知	翻译出错，请更新
toes 未知	翻译出错，请更新
toffee 未知	翻译出错，请更新
tones 未知	翻译出错，请更新
tongues 未知	翻译出错，请更新
torture 未知	翻译出错，请更新
toss 未知	翻译出错，请更新
touching 未知	触及
tour 未知	翻译出错，请更新
townsman 未知	翻译出错，请更新
toy 未知	翻译出错，请更新
traceries 未知	翻译出错，请更新
traffic 未知	翻译出错，请更新
tragedy 未知	翻译出错，请更新
training 未知	翻译出错，请更新
trammels 未知	翻译出错，请更新
transferred 未知	翻译出错，请更新
travellers 未知	翻译出错，请更新
travels 未知	翻译出错，请更新
treating 未知	翻译出错，请更新
treatment 未知	翻译出错，请更新
tremor 未知	翻译出错，请更新
tributaries 未知	翻译出错，请更新
trifling 未知	翻译出错，请更新
trotted 未知	翻译出错，请更新
troublesome 未知	翻译出错，请更新
truer 未知	翻译出错，请更新
trump 未知	翻译出错，请更新
trumps 未知	翻译出错，请更新
tune 未知	翻译出错，请更新
tussle 未知	翻译出错，请更新
twelvemonth 未知	翻译出错，请更新
twentyfour 未知	翻译出错，请更新
twentyone 未知	翻译出错，请更新
twentyseven 未知	翻译出错，请更新
twentythree 未知	翻译出错，请更新
twentytwo 未知	翻译出错，请更新
tyrant 未知	翻译出错，请更新
ultimate 未知	翻译出错，请更新
ultimately 未知	翻译出错，请更新
un 未知	翻译出错，请更新
unanimous 未知	翻译出错，请更新
unattractive 未知	翻译出错，请更新
unbecoming 未知	翻译出错，请更新
unbounded 未知	翻译出错，请更新
unbroken 未知	翻译出错，请更新
uncommonly 未知	翻译出错，请更新
undying 未知	翻译出错，请更新
uneasily 未知	翻译出错，请更新
unexceptionable 未知	翻译出错，请更新
unfixed 未知	翻译出错，请更新
unintelligible 未知	翻译出错，请更新
universal 未知	翻译出错，请更新
unpleasantly 未知	翻译出错，请更新
unpopular 未知	翻译出错，请更新
unprotected 未知	翻译出错，请更新
unsaid 未知	翻译出错，请更新
unscrupulous 未知	翻译出错，请更新
unseemly 未知	翻译出错，请更新
unsteady 未知	翻译出错，请更新
unusual 未知	翻译出错，请更新
unwelcome 未知	翻译出错，请更新
unwise 未知	翻译出错，请更新
uppermost 未知	翻译出错，请更新
upset 未知	翻译出错，请更新
urgent 未知	翻译出错，请更新
urging 未知	翻译出错，请更新
utility 未知	翻译出错，请更新
vacate 未知	翻译出错，请更新
vacated 未知	翻译出错，请更新
vague 未知	翻译出错，请更新
vagueness 未知	翻译出错，请更新
vainly 未知	翻译出错，请更新
valid 未知	翻译出错，请更新
valued 未知	翻译出错，请更新
vantage 未知	翻译出错，请更新
veil 未知	翻译出错，请更新
velvet 未知	翻译出错，请更新
venerable 未知	翻译出错，请更新
verdict 未知	翻译出错，请更新
verge 未知	翻译出错，请更新
vessel 未知	翻译出错，请更新
vexed 未知	翻译出错，请更新
victim 未知	翻译出错，请更新
vile 未知	翻译出错，请更新
vixen 未知	翻译出错，请更新
vocation 未知	翻译出错，请更新
void 未知	翻译出错，请更新
vow 未知	翻译出错，请更新
wack 未知	翻译出错，请更新
waggonet 未知	翻译出错，请更新
wailings 未知	翻译出错，请更新
waist 未知	翻译出错，请更新
waistcoat 未知	翻译出错，请更新
walks 未知	翻译出错，请更新
ward 未知	翻译出错，请更新
warmer 未知	翻译出错，请更新
wash 未知	翻译出错，请更新
washing 未知	翻译出错，请更新
watching 未知	翻译出错，请更新
wax 未知	翻译出错，请更新
waxing 未知	翻译出错，请更新
wearied 未知	翻译出错，请更新
weigh 未知	翻译出错，请更新
welcomed 未知	翻译出错，请更新
wellcut 未知	翻译出错，请更新
wellinformed 未知	翻译出错，请更新
welllooking 未知	翻译出错，请更新
wept 未知	翻译出错，请更新
west 未知	翻译出错，请更新
wherever 未知	翻译出错，请更新
whichever 未知	翻译出错，请更新
whiskers 未知	翻译出错，请更新
whispering 未知	翻译出错，请更新
whit 未知	翻译出错，请更新
whither 未知	翻译出错，请更新
whod 未知	翻译出错，请更新
wickedness 未知	翻译出错，请更新
widest 未知	翻译出错，请更新
wilderness 未知	翻译出错，请更新
wildest 未知	翻译出错，请更新
wildly 未知	翻译出错，请更新
willingness 未知	翻译出错，请更新
wincing 未知	翻译出错，请更新
windbags 未知	翻译出错，请更新
windfall 未知	翻译出错，请更新
wisely 未知	翻译出错，请更新
wistfully 未知	翻译出错，请更新
withdrawing 未知	翻译出错，请更新
witness 未知	翻译出错，请更新
wits 未知	翻译出错，请更新
witty 未知	翻译出错，请更新
woke 未知	翻译出错，请更新
womanly 未知	翻译出错，请更新
womens 未知	翻译出错，请更新
woo 未知	翻译出错，请更新
wooden 未知	翻译出错，请更新
woodmans 未知	翻译出错，请更新
woods 未知	翻译出错，请更新
worded 未知	翻译出错，请更新
worldly 未知	翻译出错，请更新
wote 未知	翻译出错，请更新
wotes 未知	翻译出错，请更新
wretch 未知	翻译出错，请更新
writingtable 未知	翻译出错，请更新
wrongly 未知	翻译出错，请更新
yachting 未知	翻译出错，请更新
yard 未知	翻译出错，请更新
yearly 未知	翻译出错，请更新
yielded 未知	翻译出错，请更新
zealous 未知	翻译出错，请更新
AUNT 未知	翻译出错，请更新
Abingdon 未知	翻译出错，请更新
Act 未知	翻译出错，请更新
Administration 未知	翻译出错，请更新
Admirably 未知	翻译出错，请更新
Admiral 未知	翻译出错，请更新
Africa 未知	翻译出错，请更新
Agree 未知	翻译出错，请更新
Akinetos 未知	翻译出错，请更新
Akinetoses 未知	翻译出错，请更新
Albany 未知	翻译出错，请更新
Alderman 未知	翻译出错，请更新
Alone 未知	翻译出错，请更新
Alps 未知	翻译出错，请更新
Although 未知	翻译出错，请更新
Altogether 未知	翻译出错，请更新
Always 未知	翻译出错，请更新
Amantium 未知	翻译出错，请更新
Amen 未知	翻译出错，请更新
Americans 未知	翻译出错，请更新
Anyone 未知	翻译出错，请更新
Anyways 未知	翻译出错，请更新
Apollo 未知	翻译出错，请更新
Apollyon 未知	翻译出错，请更新
Apologise 未知	翻译出错，请更新
Archbishop 未知	翻译出错，请更新
Archbishops 未知	翻译出错，请更新
Argument 未知	翻译出错，请更新
Arrangements 未知	翻译出错，请更新
Art 未知	翻译出错，请更新
Ascot 未知	翻译出错，请更新
Ass 未知	翻译出错，请更新
Assignations 未知	翻译出错，请更新
Atlas 未知	翻译出错，请更新
AttorneyGeneralship 未知	翻译出错，请更新
Au 未知	翻译出错，请更新
Audley 未知	翻译出错，请更新
Australia 未知	翻译出错，请更新
Autumnal 未知	翻译出错，请更新
BUNCE 未知	翻译出错，请更新
Babara 未知	翻译出错，请更新
Bad 未知	翻译出错，请更新
Bagnalls 未知	翻译出错，请更新
Baker 未知	翻译出错，请更新
Ballinasloe 未知	翻译出错，请更新
Ballot 未知	翻译出错，请更新
Ballotbox 未知	翻译出错，请更新
Banners 未知	翻译出错，请更新
Bantam 未知	翻译出错，请更新
Barker 未知	翻译出错，请更新
Barney 未知	翻译出错，请更新
Barringtons 未知	翻译出错，请更新
Barset 未知	翻译出错，请更新
Barsetshire 未知	翻译出错，请更新
Bay 未知	翻译出错，请更新
Bean 未知	翻译出错，请更新
Beating 未知	翻译出错，请更新
Beautiful 未知	翻译出错，请更新
Beginning 未知	翻译出错，请更新
Being 未知	翻译出错，请更新
Bests 未知	翻译出错，请更新
Better 未知	翻译出错，请更新
Bible 未知	翻译出错，请更新
Bid 未知	翻译出错，请更新
Bishops 未知	翻译出错，请更新
Bits 未知	翻译出错，请更新
Bloodstone 未知	翻译出错，请更新
Blow 未知	翻译出错，请更新
Bohemians 未知	翻译出错，请更新
Bond 未知	翻译出错，请更新
Bosanquets 未知	翻译出错，请更新
Botany 未知	翻译出错，请更新
Bother 未知	翻译出错，请更新
Bridge 未知	翻译出错，请更新
Bristol 未知	翻译出错，请更新
Briton 未知	翻译出错，请更新
Britons 未知	翻译出错，请更新
Broadbury 未知	翻译出错，请更新
Brodericks 未知	翻译出错，请更新
Bucklersbury 未知	翻译出错，请更新
Bully 未知	翻译出错，请更新
Buncean 未知	翻译出错，请更新
Burn 未知	翻译出错，请更新
Burns 未知	翻译出错，请更新
Business 未知	翻译出错，请更新
Byron 未知	翻译出错，请更新
CANTRIP 未知	翻译出错，请更新
Caesar 未知	翻译出错，请更新
Calling 未知	翻译出错，请更新
Canadian 未知	翻译出错，请更新
Canning 未知	翻译出错，请更新
Cannot 未知	翻译出错，请更新
Canterbury 未知	翻译出错，请更新
CantripFinn 未知	翻译出错，请更新
Cape 未知	翻译出错，请更新
Capitalists 未知	翻译出错，请更新
Ccdq 未知	翻译出错，请更新
Cham 未知	翻译出错，请更新
Chance 未知	翻译出错，请更新
Change 未知	翻译出错，请更新
Changed 未知	翻译出错，请更新
Channel 未知	翻译出错，请更新
Charing 未知	翻译出错，请更新
Chelsea 未知	翻译出错，请更新
Chesterfieldian 未知	翻译出错，请更新
Chickerwick 未知	翻译出错，请更新
China 未知	翻译出错，请更新
Choosing 未知	翻译出错，请更新
Christ 未知	翻译出错，请更新
Cincinnatus 未知	翻译出错，请更新
Circuit 未知	翻译出错，请更新
Circulars 未知	翻译出错，请更新
Clandestine 未知	翻译出错，请更新
Claptrap 未知	翻译出错，请更新
Close 未知	翻译出错，请更新
Closed 未知	翻译出错，请更新
Clubs 未知	翻译出错，请更新
Colcleugh 未知	翻译出错，请更新
Committees 未知	翻译出错，请更新
Common 未知	翻译出错，请更新
Comparing 未知	翻译出错，请更新
Comptroller 未知	翻译出错，请更新
Conclusion 未知	翻译出错，请更新
Connell 未知	翻译出错，请更新
Conservatism 未知	翻译出错，请更新
Consolation 未知	翻译出错，请更新
Convictions 未知	翻译出错，请更新
Conway 未知	翻译出错，请更新
Corn 未知	翻译出错，请更新
Couldnt 未知	翻译出错，请更新
Councils 未知	翻译出错，请更新
Countess 未知	翻译出错，请更新
Coventry 未知	翻译出错，请更新
Croesus 未知	翻译出错，请更新
Cromwell 未知	翻译出错，请更新
Cruel 未知	翻译出错，请更新
DEAREST 未知	翻译出错，请更新
Dash 未知	翻译出错，请更新
Davis 未知	翻译出错，请更新
Dean 未知	翻译出错，请更新
Debate 未知	翻译出错，请更新
Degrade 未知	翻译出错，请更新
Democrat 未知	翻译出错，请更新
Derg 未知	翻译出错，请更新
Devonshire 未知	翻译出错，请更新
Dials 未知	翻译出错，请更新
Doing 未知	翻译出错，请更新
Don 未知	翻译出错，请更新
Doncaster 未知	翻译出错，请更新
Dooty 未知	翻译出错，请更新
Dorchester 未知	翻译出错，请更新
Dorsetshire 未知	翻译出错，请更新
Dou 未知	翻译出错，请更新
Down 未知	翻译出错，请更新
Drat 未知	翻译出错，请更新
Dream 未知	翻译出错，请更新
Duellists 未知	翻译出错，请更新
Dufferty 未知	翻译出错，请更新
Dull 未知	翻译出错，请更新
Dye 未知	翻译出错，请更新
E 未知	翻译出错，请更新
EFFINGHAM 未知	翻译出错，请更新
Eaton 未知	翻译出错，请更新
Edinburgh 未知	翻译出错，请更新
Edwards 未知	翻译出错，请更新
Elysium 未知	翻译出错，请更新
Emigration 未知	翻译出错，请更新
Emily 未知	翻译出错，请更新
Empingham 未知	翻译出错，请更新
End 未知	翻译出错，请更新
Endowments 未知	翻译出错，请更新
Enervating 未知	翻译出错，请更新
Englishman 未知	翻译出错，请更新
Englishmans 未知	翻译出错，请更新
Englishwomen 未知	翻译出错，请更新
Ennistimon 未知	翻译出错，请更新
Envious 未知	翻译出错，请更新
Equality 未知	翻译出错，请更新
Esq 未知	翻译出错，请更新
Essex 未知	翻译出错，请更新
Establishment 未知	翻译出错，请更新
Euston 未知	翻译出错，请更新
Everards 未知	翻译出错，请更新
Evergreens 未知	翻译出错，请更新
Everton 未知	翻译出错，请更新
Eves 未知	翻译出错，请更新
Exceedingly 未知	翻译出错，请更新
Exodus 未知	翻译出错，请更新
Exton 未知	翻译出错，请更新
Eye 未知	翻译出错，请更新
FATHER 未知	翻译出错，请更新
FRIEND 未知	翻译出错，请更新
Failing 未知	翻译出错，请更新
Fair 未知	翻译出错，请更新
Farewell 未知	翻译出错，请更新
Farmers 未知	翻译出错，请更新
Fawns 未知	翻译出错，请更新
Feb 未知	翻译出错，请更新
Fells 未知	翻译出错，请更新
Female 未知	翻译出错，请更新
Fenianism 未知	翻译出错，请更新
Fetter 未知	翻译出错，请更新
Few 未知	翻译出错，请更新
Fifteen 未知	翻译出错，请更新
Fifty 未知	翻译出错，请更新
Finding 未知	翻译出错，请更新
Finny 未知	翻译出错，请更新
Finsbury 未知	翻译出错，请更新
Firm 未知	翻译出错，请更新
Fitz 未知	翻译出错，请更新
FitzHoward 未知	翻译出错，请更新
Fitzwilliam 未知	翻译出错，请更新
Fitzwilliams 未知	翻译出错，请更新
Five 未知	翻译出错，请更新
Floscabel 未知	翻译出错，请更新
Fond 未知	翻译出错，请更新
Fool 未知	翻译出错，请更新
Foolish 未知	翻译出错，请更新
Foolscap 未知	翻译出错，请更新
Force 未知	翻译出错，请更新
Foreseeing 未知	翻译出错，请更新
Forget 未知	翻译出错，请更新
Forgive 未知	翻译出错，请更新
Fought 未知	翻译出错，请更新
Foulsham 未知	翻译出错，请更新
Frail 未知	翻译出错，请更新
Freemantle 未知	翻译出错，请更新
Freemantles 未知	翻译出错，请更新
GLENCORA 未知	翻译出错，请更新
Gallery 未知	翻译出错，请更新
Gardens 未知	翻译出错，请更新
Garrotted 未知	翻译出错，请更新
Gatton 未知	翻译出错，请更新
Generals 未知	翻译出错，请更新
Gentleman 未知	翻译出错，请更新
Gidding 未知	翻译出错，请更新
Gingham 未知	翻译出错，请更新
Giving 未知	翻译出错，请更新
Gold 未知	翻译出错，请更新
Governor 未知	翻译出错，请更新
Granaries 未知	翻译出错，请更新
Greece 未知	翻译出错，请更新
Grogram 未知	翻译出错，请更新
Grouse 未知	翻译出错，请更新
Grove 未知	翻译出错，请更新
Guid 未知	翻译出错，请更新
Gussy 未知	翻译出错，请更新
HONOURED 未知	翻译出错，请更新
Ha 未知	翻译出错，请更新
Hamlets 未知	翻译出错，请更新
Hazledean 未知	翻译出错，请更新
Hear 未知	翻译出错，请更新
Heart 未知	翻译出错，请更新
Hed 未知	翻译出错，请更新
Henry 未知	翻译出错，请更新
Herculean 未知	翻译出错，请更新
Hercules 未知	翻译出错，请更新
Highlanders 未知	翻译出错，请更新
Holborn 未知	翻译出错，请更新
Hold 未知	翻译出错，请更新
Holland 未知	翻译出错，请更新
Holyhead 未知	翻译出错，请更新
Homer 未知	翻译出错，请更新
Honest 未知	翻译出错，请更新
Hong 未知	翻译出错，请更新
Household 未知	翻译出错，请更新
Huntingdonshire 未知	翻译出错，请更新
Hurrah 未知	翻译出错，请更新
III 未知	翻译出错，请更新
Icarus 未知	翻译出错，请更新
Ideas 未知	翻译出错，请更新
Idiot 未知	翻译出错，请更新
Illused 未知	翻译出错，请更新
Imbecility 未知	翻译出错，请更新
Individual 未知	翻译出错，请更新
Infamous 未知	翻译出错，请更新
Inspector 未知	翻译出错，请更新
Ionic 未知	翻译出错，请更新
Irishmans 未知	翻译出错，请更新
Italy 未知	翻译出错，请更新
Itd 未知	翻译出错，请更新
Itll 未知	翻译出错，请更新
JANE 未知	翻译出错，请更新
JONES 未知	翻译出错，请更新
JOSHUA 未知	翻译出错，请更新
Jacks 未知	翻译出错，请更新
Jamaica 未知	翻译出错，请更新
Jases 未知	翻译出错，请更新
Jefferson 未知	翻译出错，请更新
Jericho 未知	翻译出错，请更新
Jewess 未知	翻译出错，请更新
Jews 未知	翻译出错，请更新
Jobs 未知	翻译出错，请更新
Jock 未知	翻译出错，请更新
John 未知	翻译出错，请更新
Joshua 未知	翻译出错，请更新
Journal 未知	翻译出错，请更新
Juan 未知	翻译出错，请更新
Julius 未知	翻译出错，请更新
Kingston 未知	翻译出错，请更新
Kong 未知	翻译出错，请更新
LADY 未知	翻译出错，请更新
LK 未知	翻译出错，请更新
LORD 未知	翻译出错，请更新
LOW 未知	翻译出错，请更新
Ladies 未知	翻译出错，请更新
Lancashire 未知	翻译出错，请更新
Last 未知	翻译出错，请更新
Late 未知	翻译出错，请更新
Lately 未知	翻译出错，请更新
Laurences 未知	翻译出错，请更新
Laws 未知	翻译出错，请更新
Lets 未知	翻译出错，请更新
Lies 未知	翻译出错，请更新
Light 未知	翻译出错，请更新
Lille 未知	翻译出错，请更新
Little 未知	翻译出错，请更新
Liverpool 未知	翻译出错，请更新
Llanwrwsth 未知	翻译出错，请更新
Lody 未知	翻译出错，请更新
Loughlinters 未知	翻译出错，请更新
Loughshanes 未知	翻译出错，请更新
Luckily 未知	翻译出错，请更新
MADAME 未知	翻译出错，请更新
MARY 未知	翻译出错，请更新
MONK 未知	翻译出错，请更新
MT 未知	翻译出错，请更新
MacFies 未知	翻译出错，请更新
MacNabs 未知	翻译出错，请更新
Mackenzie 未知	翻译出错，请更新
Macnab 未知	翻译出错，请更新
Maggiore 未知	翻译出错，请更新
Magnificent 未知	翻译出错，请更新
Maid 未知	翻译出错，请更新
Maker 未知	翻译出错，请更新
Making 未知	翻译出错，请更新
Malachi 未知	翻译出错，请更新
Mansion 未知	翻译出错，请更新
Marchioness 未知	翻译出错，请更新
Margarets 未知	翻译出错，请更新
Marian 未知	翻译出错，请更新
Marry 未知	翻译出错，请更新
Marseilles 未知	翻译出错，请更新
Maryleboners 未知	翻译出错，请更新
Master 未知	翻译出错，请更新
Matrimony 未知	翻译出错，请更新
Mayfair 未知	翻译出错，请更新
Maynooth 未知	翻译出错，请更新
Mayor 未知	翻译出错，请更新
Melton 未知	翻译出错，请更新
Member 未知	翻译出错，请更新
Members 未知	翻译出错，请更新
Mention 未知	翻译出错，请更新
Mere 未知	翻译出错，请更新
Middle 未知	翻译出错，请更新
Middlesex 未知	翻译出错，请更新
Mike 未知	翻译出错，请更新
Ministerial 未知	翻译出错，请更新
Missionaries 未知	翻译出错，请更新
Mister 未知	翻译出错，请更新
Mistress 未知	翻译出错，请更新
Mohuns 未知	翻译出错，请更新
Moles 未知	翻译出错，请更新
Moore 未知	翻译出错，请更新
Moreover 未知	翻译出错，请更新
Morning 未知	翻译出错，请更新
Morriss 未知	翻译出错，请更新
Mothersinlaw 未知	翻译出错，请更新
Mountain 未知	翻译出错，请更新
Mousetrap 未知	翻译出错，请更新
Moydrum 未知	翻译出错，请更新
Muses 未知	翻译出错，请更新
Name 未知	翻译出错，请更新
National 未知	翻译出错，请更新
Near 未知	翻译出错，请更新
Nelson 未知	翻译出错，请更新
News 未知	翻译出错，请更新
Next 未知	翻译出错，请更新
Nineteen 未知	翻译出错，请更新
Noone 未知	翻译出错，请更新
Nova 未知	翻译出错，请更新
Nowhere 未知	翻译出错，请更新
Nows 未知	翻译出错，请更新
OMNIUM 未知	翻译出错，请更新
Oakham 未知	翻译出错，请更新
Oblige 未知	翻译出错，请更新
Often 未知	翻译出错，请更新
Oireland 未知	翻译出错，请更新
Opposition 未知	翻译出错，请更新
Orange 未知	翻译出错，请更新
Orion 未知	翻译出错，请更新
Others 未知	翻译出错，请更新
Otherwise 未知	翻译出错，请更新
Ouses 未知	翻译出错，请更新
Outside 未知	翻译出错，请更新
PF 未知	翻译出错，请更新
PS 未知	翻译出错，请更新
Paladin 未知	翻译出错，请更新
Pandemoniums 未知	翻译出错，请更新
Paraguay 未知	翻译出错，请更新
Pardoe 未知	翻译出错，请更新
Parliaments 未知	翻译出错，请更新
Partly 未知	翻译出错，请更新
Party 未知	翻译出错，请更新
Passing 未知	翻译出错，请更新
Passion 未知	翻译出错，请更新
Patagonia 未知	翻译出错，请更新
Patrick 未知	翻译出错，请更新
Peas 未知	翻译出错，请更新
Peels 未知	翻译出错，请更新
Penates 未知	翻译出错，请更新
Peopled 未知	翻译出错，请更新
Personally 未知	翻译出错，请更新
Persuade 未知	翻译出错，请更新
Perth 未知	翻译出错，请更新
Petersburg 未知	翻译出错，请更新
Piccadilly 未知	翻译出错，请更新
Piddle 未知	翻译出错，请更新
Placed 未知	翻译出错，请更新
Plans 未知	翻译出错，请更新
Plantagenetasked 未知	翻译出错，请更新
Plinlimmons 未知	翻译出错，请更新
Plummer 未知	翻译出错，请更新
Poland 未知	翻译出错，请更新
Poldoodie 未知	翻译出错，请更新
Politically 未知	翻译出错，请更新
Politics 未知	翻译出错，请更新
Pomfret 未知	翻译出错，请更新
Pop 未知	翻译出错，请更新
Portrait 未知	翻译出错，请更新
Post 未知	翻译出错，请更新
Potted 未知	翻译出错，请更新
Pottery 未知	翻译出错，请更新
Power 未知	翻译出错，请更新
Ppc 未知	翻译出错，请更新
Pressed 未知	翻译出错，请更新
Prince 未知	翻译出错，请更新
Princess 未知	翻译出错，请更新
Priory 未知	翻译出错，请更新
Private 未知	翻译出错，请更新
Progressive 未知	翻译出错，请更新
Promotion 未知	翻译出错，请更新
Protestants 未知	翻译出错，请更新
Provoked 未知	翻译出错，请更新
Put 未知	翻译出错，请更新
Pyrenees 未知	翻译出错，请更新
QC 未知	翻译出错，请更新
QS 未知	翻译出错，请更新
Quick 未知	翻译出错，请更新
Quixotic 未知	翻译出错，请更新
ROBERT 未知	翻译出错，请更新
Radicalism 未知	翻译出错，请更新
Railroad 未知	翻译出错，请更新
Rara 未知	翻译出错，请更新
Ratlerite 未知	翻译出错，请更新
Reformer 未知	翻译出错，请更新
Reformers 未知	翻译出错，请更新
Refuse 未知	翻译出错，请更新
Repeal 未知	翻译出错，请更新
Repose 未知	翻译出错，请更新
Republican 未知	翻译出错，请更新
Respectable 未知	翻译出错，请更新
Returning 未知	翻译出错，请更新
Rhine 未知	翻译出错，请更新
Ribandmen 未知	翻译出错，请更新
Richards 未知	翻译出错，请更新
Riding 未知	翻译出错，请更新
Riga 未知	翻译出错，请更新
Rights 未知	翻译出错，请更新
River 未知	翻译出错，请更新
Robys 未知	翻译出错，请更新
Rochester 未知	翻译出错，请更新
Rolls 未知	翻译出错，请更新
Rotunda 未知	翻译出错，请更新
Rumour 未知	翻译出错，请更新
Rusty 未知	翻译出错，请更新
SIR 未知	翻译出错，请更新
STANDISH 未知	翻译出错，请更新
Samson 未知	翻译出错，请更新
Sarsnet 未知	翻译出错，请更新
Sarum 未知	翻译出错，请更新
Saulsbys 未知	翻译出错，请更新
Scores 未知	翻译出错，请更新
Scotia 未知	翻译出错，请更新
Scott 未知	翻译出错，请更新
Scrubi 未知	翻译出错，请更新
Seen 未知	翻译出错，请更新
Serve 未知	翻译出错，请更新
Set 未知	翻译出错，请更新
Shakespeare 未知	翻译出错，请更新
Shell 未知	翻译出错，请更新
Shes 未知	翻译出错，请更新
Shoot 未知	翻译出错，请更新
Shop 未知	翻译出错，请更新
Shortly 未知	翻译出错，请更新
Shouldnt 未知	翻译出错，请更新
Signor 未知	翻译出错，请更新
Simeon 未知	翻译出错，请更新
Singular 未知	翻译出错，请更新
Sitting 未知	翻译出错，请更新
Sixmiletown 未知	翻译出错，请更新
Slowly 未知	翻译出错，请更新
Smith 未知	翻译出错，请更新
Socially 未知	翻译出错，请更新
Society 未知	翻译出错，请更新
Solicitor 未知	翻译出错，请更新
Sooner 未知	翻译出错，请更新
Sovereign 未知	翻译出错，请更新
Sporting 未知	翻译出错，请更新
Staleybridge 未知	翻译出错，请更新
Stars 未知	翻译出错，请更新
Stay 未知	翻译出错，请更新
Staying 未知	翻译出错，请更新
Stick 未知	翻译出错，请更新
Stilton 未知	翻译出错，请更新
Stirling 未知	翻译出错，请更新
Stirlings 未知	翻译出错，请更新
Stratford 未知	翻译出错，请更新
Stupid 未知	翻译出错，请更新
Submission 未知	翻译出错，请更新
Success 未知	翻译出错，请更新
Successful 未知	翻译出错，请更新
Suffering 未知	翻译出错，请更新
Sufficient 未知	翻译出错，请更新
Suffolk 未知	翻译出错，请更新
Supposing 未知	翻译出错，请更新
Sutton 未知	翻译出错，请更新
Sympathy 未知	翻译出错，请更新
Ta 未知	翻译出错，请更新
Tailby 未知	翻译出错，请更新
Tailbys 未知	翻译出错，请更新
Taking 未知	翻译出错，请更新
Tantalus 未知	翻译出错，请更新
Teddington 未知	翻译出错，请更新
Temper 未知	翻译出错，请更新
Temple 未知	翻译出错，请更新
Temptress 未知	翻译出错，请更新
TenantRight 未知	翻译出错，请更新
Tenantright 未知	翻译出错，请更新
Tennyson 未知	翻译出错，请更新
Terrace 未知	翻译出错，请更新
Thankye 未知	翻译出错，请更新
Theyd 未知	翻译出错，请更新
Thinking 未知	翻译出错，请更新
Thou 未知	翻译出错，请更新
Thrice 未知	翻译出错，请更新
Throughout 未知	翻译出错，请更新
Thursdays 未知	翻译出错，请更新
Today 未知	翻译出错，请更新
Together 未知	翻译出错，请更新
Tom 未知	翻译出错，请更新
Travellers 未知	翻译出错，请更新
Treated 未知	翻译出错，请更新
Trip 未知	翻译出错，请更新
Troubled 未知	翻译出错，请更新
True 未知	翻译出错，请更新
Turkey 未知	翻译出错，请更新
Turn 未知	翻译出错，请更新
UnderSecretaries 未知	翻译出错，请更新
UnderSecretarys 未知	翻译出错，请更新
UnderSecretaryships 未知	翻译出错，请更新
Undue 未知	翻译出错，请更新
Unfortunate 未知	翻译出错，请更新
University 未知	翻译出错，请更新
Unless 未知	翻译出错，请更新
Unmarried 未知	翻译出错，请更新
VIOLET 未知	翻译出错，请更新
Vi 未知	翻译出错，请更新
ViceChancellor 未知	翻译出错，请更新
ViceComptroller 未知	翻译出错，请更新
VicePresidents 未知	翻译出错，请更新
Victrix 未知	翻译出错，请更新
Viennese 未知	翻译出错，请更新
Vile 未知	翻译出错，请更新
W 未知	翻译出错，请更新
Wait 未知	翻译出错，请更新
Walker 未知	翻译出错，请更新
Walpole 未知	翻译出错，请更新
Washington 未知	翻译出错，请更新
Wasnt 未知	翻译出错，请更新
Weazeling 未知	翻译出错，请更新
Week 未知	翻译出错，请更新
Westmoreland 未知	翻译出错，请更新
Whatshisname 未知	翻译出错，请更新
Whence 未知	翻译出错，请更新
Whereas 未知	翻译出错，请更新
Wherever 未知	翻译出错，请更新
Whither 未知	翻译出错，请更新
Whitsuntide 未知	翻译出错，请更新
Whoever 未知	翻译出错，请更新
Wilcox 未知	翻译出错，请更新
William 未知	翻译出错，请更新
Wiltshire 未知	翻译出错，请更新
Wissindine 未知	翻译出错，请更新
Withdraw 未知	翻译出错，请更新
Womens 未知	翻译出错，请更新
Woods 未知	翻译出错，请更新
Words 未知	翻译出错，请更新
Workmen 未知	翻译出错，请更新
Years 未知	翻译出错，请更新
Yesterday 未知	翻译出错，请更新
Yet 未知	翻译出错，请更新
Youd 未知	翻译出错，请更新
Youth 未知	翻译出错，请更新
Zoological 未知	翻译出错，请更新
abandoning 未知	翻译出错，请更新
abdicated 未知	翻译出错，请更新
abdication 未知	翻译出错，请更新
abduction 未知	翻译出错，请更新
abeyance 未知	翻译出错，请更新
abject 未知	翻译出错，请更新
abler 未知	翻译出错，请更新
abnegation 未知	翻译出错，请更新
abode 未知	翻译出错，请更新
abodes 未知	翻译出错，请更新
abominate 未知	翻译出错，请更新
abomination 未知	翻译出错，请更新
abominations 未知	翻译出错，请更新
aboon 未知	翻译出错，请更新
abortive 未知	翻译出错，请更新
absented 未知	翻译出错，请更新
absorbed 未知	翻译出错，请更新
absorbing 未知	翻译出错，请更新
abstaining 未知	翻译出错，请更新
abstains 未知	翻译出错，请更新
abstinence 未知	翻译出错，请更新
absurdly 未知	翻译出错，请更新
abundant 未知	翻译出错，请更新
abusing 未知	翻译出错，请更新
acceded 未知	翻译出错，请更新
accent 未知	翻译出错，请更新
access 未知	翻译出错，请更新
acclamation 未知	翻译出错，请更新
accommodated 未知	翻译出错，请更新
accommodation 未知	翻译出错，请更新
accompanied 未知	翻译出错，请更新
accompanying 未知	翻译出错，请更新
accomplishments 未知	翻译出错，请更新
accusations 未知	翻译出错，请更新
acerbate 未知	翻译出错，请更新
achievements 未知	翻译出错，请更新
acknowledges 未知	翻译出错，请更新
acknowledgment 未知	翻译出错，请更新
acquaintances 未知	翻译出错，请更新
acquire 未知	翻译出错，请更新
acquirement 未知	翻译出错，请更新
actions 未知	翻译出错，请更新
adaptation 未知	翻译出错，请更新
adapts 未知	翻译出错，请更新
addresses 未知	翻译出错，请更新
adduce 未知	翻译出错，请更新
adequately 未知	翻译出错，请更新
adherent 未知	翻译出错，请更新
adjoining 未知	翻译出错，请更新
adjunct 未知	翻译出错，请更新
adjustment 未知	翻译出错，请更新
admirably 未知	翻译出错，请更新
admirers 未知	翻译出错，请更新
admires 未知	翻译出错，请更新
admonitions 未知	翻译出错，请更新
adroitness 未知	翻译出错，请更新
adulated 未知	翻译出错，请更新
advancement 未知	翻译出错，请更新
advances 未知	翻译出错，请更新
advancing 未知	翻译出错，请更新
advantageous 未知	翻译出错，请更新
adventurous 未知	翻译出错，请更新
advertised 未知	翻译出错，请更新
advises 未知	翻译出错，请更新
advocates 未知	翻译出错，请更新
advocating 未知	翻译出错，请更新
aegis 未知	翻译出错，请更新
afeard 未知	翻译出错，请更新
affecting 未知	翻译出错，请更新
affects 未知	翻译出错，请更新
affirmation 未知	翻译出错，请更新
affixed 未知	翻译出错，请更新
affliction 未知	翻译出错，请更新
affords 未知	翻译出错，请更新
affray 未知	翻译出错，请更新
aggravating 未知	翻译出错，请更新
aggrieved 未知	翻译出错，请更新
agoverning 未知	翻译出错，请更新
agreeing 未知	翻译出错，请更新
agriculture 未知	翻译出错，请更新
ah 未知	翻译出错，请更新
ahurrying 未知	翻译出错，请更新
aided 未知	翻译出错，请更新
ailments 未知	翻译出错，请更新
airy 未知	翻译出错，请更新
akin 未知	翻译出错，请更新
alacrity 未知	翻译出错，请更新
alarm 未知	翻译出错，请更新
allegation 未知	翻译出错，请更新
alleged 未知	翻译出错，请更新
alley 未知	翻译出错，请更新
alleys 未知	翻译出错，请更新
allied 未知	翻译出错，请更新
allimportant 未知	翻译出错，请更新
allocated 未知	翻译出错，请更新
allotted 未知	翻译出错，请更新
alloy 未知	翻译出错，请更新
allpowerful 未知	翻译出错，请更新
allpowerless 未知	翻译出错，请更新
allude 未知	翻译出错，请更新
alluding 未知	翻译出错，请更新
allure 未知	翻译出错，请更新
allurement 未知	翻译出错，请更新
alpha 未知	翻译出错，请更新
altering 未知	翻译出错，请更新
alternately 未知	翻译出错，请更新
altitude 未知	翻译出错，请更新
amazed 未知	翻译出错，请更新
amiable 未知	翻译出错，请更新
amok 未知	翻译出错，请更新
amounted 未知	翻译出错，请更新
amounts 未知	翻译出错，请更新
amphitheatre 未知	翻译出错，请更新
amused 未知	翻译出错，请更新
analyse 未知	翻译出错，请更新
anathematised 未知	翻译出错，请更新
ands 未知	翻译出错，请更新
anew 未知	翻译出错，请更新
angelic 未知	翻译出错，请更新
angels 未知	翻译出错，请更新
angered 未知	翻译出错，请更新
angs 未知	翻译出错，请更新
anguish 未知	翻译出错，请更新
animals 未知	翻译出错，请更新
animated 未知	翻译出错，请更新
announce 未知	翻译出错，请更新
annoys 未知	翻译出错，请更新
annually 未知	翻译出错，请更新
antagonistic 未知	翻译出错，请更新
anticipate 未知	翻译出错，请更新
anticipating 未知	翻译出错，请更新
antidote 未知	翻译出错，请更新
antipathetic 未知	翻译出错，请更新
antiquated 未知	翻译出错，请更新
anxiously 未知	翻译出错，请更新
anyhow 未知	翻译出错，请更新
anyways 未知	翻译出错，请更新
apartments 未知	翻译出错，请更新
apologetic 未知	翻译出错，请更新
apologised 未知	翻译出错，请更新
apparition 未知	翻译出错，请更新
appeals 未知	翻译出错，请更新
appearances 未知	翻译出错，请更新
applauded 未知	翻译出错，请更新
apples 未知	翻译出错，请更新
appliance 未知	翻译出错，请更新
application 未知	翻译出错，请更新
applies 未知	翻译出错，请更新
appreciated 未知	翻译出错，请更新
apprehension 未知	翻译出错，请更新
approaches 未知	翻译出错，请更新
approbation 未知	翻译出错，请更新
appropriated 未知	翻译出错，请更新
approval 未知	翻译出错，请更新
aprons 未知	翻译出错，请更新
aptitudes 未知	翻译出错，请更新
aquiline 未知	翻译出错，请更新
archers 未知	翻译出错，请更新
archery 未知	翻译出错，请更新
arches 未知	翻译出错，请更新
argues 未知	翻译出错，请更新
arguing 未知	翻译出错，请更新
aristocracy 未知	翻译出错，请更新
armed 未知	翻译出错，请更新
armies 未知	翻译出错，请更新
armour 未知	翻译出错，请更新
arranges 未知	翻译出错，请更新
arrear 未知	翻译出错，请更新
arresting 未知	翻译出错，请更新
arrogant 未知	翻译出错，请更新
arrow 未知	翻译出错，请更新
articulate 未知	翻译出错，请更新
artificer 未知	翻译出错，请更新
artificial 未知	翻译出错，请更新
artisan 未知	翻译出错，请更新
ascendancy 未知	翻译出错，请更新
ascent 未知	翻译出错，请更新
ascertain 未知	翻译出错，请更新
asll 未知	翻译出错，请更新
asparagus 未知	翻译出错，请更新
aspired 未知	翻译出错，请更新
aspiring 未知	翻译出错，请更新
assailed 未知	翻译出错，请更新
assemblage 未知	翻译出错，请更新
assemblies 未知	翻译出错，请更新
assenting 未知	翻译出错，请更新
asserting 未知	翻译出错，请更新
assignations 未知	翻译出错，请更新
assigned 未知	翻译出错，请更新
assistant 未知	翻译出错，请更新
assisting 未知	翻译出错，请更新
assists 未知	翻译出错，请更新
associated 未知	翻译出错，请更新
associates 未知	翻译出错，请更新
assumes 未知	翻译出错，请更新
assuming 未知	翻译出错，请更新
assumption 未知	翻译出错，请更新
assurances 未知	翻译出错，请更新
astound 未知	翻译出错，请更新
athirst 未知	翻译出错，请更新
atic 未知	翻译出错，请更新
atmosphere 未知	翻译出错，请更新
atque 未知	翻译出错，请更新
attacking 未知	翻译出错，请更新
attained 未知	翻译出错，请更新
attainment 未知	翻译出错，请更新
attesting 未知	翻译出错，请更新
attitude 未知	翻译出错，请更新
attribute 未知	翻译出错，请更新
attributing 未知	翻译出错，请更新
au 未知	翻译出错，请更新
auditors 未知	翻译出错，请更新
auguries 未知	翻译出错，请更新
auld 未知	翻译出错，请更新
auspices 未知	翻译出错，请更新
austere 未知	翻译出错，请更新
austerity 未知	翻译出错，请更新
author 未知	翻译出错，请更新
authorising 未知	翻译出错，请更新
authorities 未知	翻译出错，请更新
autocrat 未知	翻译出错，请更新
automatically 未知	翻译出错，请更新
autumnal 未知	翻译出错，请更新
availed 未知	翻译出错，请更新
aver 未知	翻译出错，请更新
avis 未知	翻译出错，请更新
avocation 未知	翻译出错，请更新
avowal 未知	翻译出错，请更新
awaiting 未知	翻译出错，请更新
awarded 未知	翻译出错，请更新
aweinspiring 未知	翻译出错，请更新
awry 未知	翻译出错，请更新
ay 未知	翻译出错，请更新
ayear 未知	翻译出错，请更新
babies 未知	翻译出错，请更新
backbroken 未知	翻译出错，请更新
backers 未知	翻译出错，请更新
background 未知	翻译出错，请更新
backs 未知	翻译出错，请更新
backward 未知	翻译出错，请更新
badgered 未知	翻译出错，请更新
baffling 未知	翻译出错，请更新
bait 未知	翻译出错，请更新
bake 未知	翻译出错，请更新
balcony 未知	翻译出错，请更新
bale 未知	翻译出错，请更新
balked 未知	翻译出错，请更新
ballad 未知	翻译出错，请更新
ballotlovers 未知	翻译出错，请更新
balls 未知	翻译出错，请更新
ballyrag 未知	翻译出错，请更新
balmy 未知	翻译出错，请更新
balustrade 未知	翻译出错，请更新
bandied 未知	翻译出错，请更新
bands 未知	翻译出错，请更新
baneful 未知	翻译出错，请更新
bankers 未知	翻译出错，请更新
banns 未知	翻译出错，请更新
banqueting 未知	翻译出错，请更新
bantering 未知	翻译出错，请更新
baptising 未知	翻译出错，请更新
baptism 未知	翻译出错，请更新
barbarity 未知	翻译出错，请更新
barbed 未知	翻译出错，请更新
bareness 未知	翻译出错，请更新
barest 未知	翻译出错，请更新
bargains 未知	翻译出错，请更新
bark 未知	翻译出错，请更新
barks 未知	翻译出错，请更新
barony 未知	翻译出错，请更新
barque 未知	翻译出错，请更新
barred 未知	翻译出错，请更新
bars 未知	翻译出错，请更新
basely 未知	翻译出错，请更新
bashfulness 未知	翻译出错，请更新
basis 未知	翻译出错，请更新
batches 未知	翻译出错，请更新
bean 未知	翻译出错，请更新
bearer 未知	翻译出错，请更新
bears 未知	翻译出错，请更新
beasty 未知	翻译出错，请更新
beats 未知	翻译出错，请更新
beauteous 未知	翻译出错，请更新
beef 未知	翻译出错，请更新
befriend 未知	翻译出错，请更新
begets 未知	翻译出错，请更新
beggars 未知	翻译出错，请更新
begrudge 未知	翻译出错，请更新
begrudged 未知	翻译出错，请更新
behest 未知	翻译出错，请更新
behests 未知	翻译出错，请更新
beholding 未知	翻译出错，请更新
behoof 未知	翻译出错，请更新
belabour 未知	翻译出错，请更新
belt 未知	翻译出错，请更新
belted 未知	翻译出错，请更新
bending 未知	翻译出错，请更新
benefited 未知	翻译出错，请更新
benevolent 未知	翻译出错，请更新
bequeathed 未知	翻译出错，请更新
bereaved 未知	翻译出错，请更新
beseeching 未知	翻译出错，请更新
bestials 未知	翻译出错，请更新
bestower 未知	翻译出错，请更新
bestowing 未知	翻译出错，请更新
bestows 未知	翻译出错，请更新
bethought 未知	翻译出错，请更新
betraying 未知	翻译出错，请更新
betrays 未知	翻译出错，请更新
betrothal 未知	翻译出错，请更新
betting 未知	翻译出错，请更新
bide 未知	翻译出错，请更新
bided 未知	翻译出错，请更新
biggest 未知	翻译出错，请更新
bigwigs 未知	翻译出错，请更新
billiard 未知	翻译出错，请更新
billiardroom 未知	翻译出错，请更新
billiards 未知	翻译出错，请更新
binding 未知	翻译出错，请更新
biographer 未知	翻译出错，请更新
biography 未知	翻译出错，请更新
bishopric 未知	翻译出错，请更新
bits 未知	翻译出错，请更新
blackballs 未知	翻译出错，请更新
blackguards 未知	翻译出错，请更新
blackly 未知	翻译出错，请更新
blackness 未知	翻译出错，请更新
blandishments 未知	翻译出错，请更新
blazes 未知	翻译出错，请更新
blazon 未知	翻译出错，请更新
blindly 未知	翻译出错，请更新
blinds 未知	翻译出错，请更新
blocked 未知	翻译出错，请更新
blot 未知	翻译出错，请更新
blundering 未知	翻译出错，请更新
blurt 未知	翻译出错，请更新
blushes 未知	翻译出错，请更新
boasted 未知	翻译出错，请更新
boastings 未知	翻译出错，请更新
boathouses 未知	翻译出错，请更新
bodily 未知	翻译出错，请更新
bog 未知	翻译出错，请更新
boiled 未知	翻译出错，请更新
bolt 未知	翻译出错，请更新
bond 未知	翻译出错，请更新
bookkeeping 未知	翻译出错，请更新
bookroom 未知	翻译出错，请更新
booth 未知	翻译出错，请更新
bootmaker 未知	翻译出错，请更新
border 未知	翻译出错，请更新
bored 未知	翻译出错，请更新
boring 未知	翻译出错，请更新
boroughmongering 未知	翻译出错，请更新
borrowed 未知	翻译出错，请更新
bother 未知	翻译出错，请更新
bothered 未知	翻译出错，请更新
bothers 未知	翻译出错，请更新
bottles 未知	翻译出错，请更新
bounds 未知	翻译出错，请更新
bowing 未知	翻译出错，请更新
bowl 未知	翻译出错，请更新
bowled 未知	翻译出错，请更新
bowwindow 未知	翻译出错，请更新
brace 未知	翻译出错，请更新
bracelets 未知	翻译出错，请更新
branch 未知	翻译出错，请更新
branches 未知	翻译出错，请更新
brandishing 未知	翻译出错，请更新
brass 未知	翻译出错，请更新
breakers 未知	翻译出错，请更新
breakfasted 未知	翻译出错，请更新
breakfasting 未知	翻译出错，请更新
breakfastroom 未知	翻译出错，请更新
breakup 未知	翻译出错，请更新
breathed 未知	翻译出错，请更新
bred 未知	翻译出错，请更新
breeding 未知	翻译出错，请更新
breezes 未知	翻译出错，请更新
brewer 未知	翻译出错，请更新
breweries 未知	翻译出错，请更新
bribery 未知	翻译出错，请更新
brideelect 未知	翻译出错，请更新
bridling 未知	翻译出错，请更新
brief 未知	翻译出错，请更新
briefless 未知	翻译出错，请更新
briefs 未知	翻译出错，请更新
brightfaced 未知	翻译出错，请更新
brightly 未知	翻译出错，请更新
brisk 未知	翻译出错，请更新
brogue 未知	翻译出错，请更新
broiling 未知	翻译出错，请更新
brokenly 未知	翻译出错，请更新
brooded 未知	翻译出错，请更新
brooding 未知	翻译出错，请更新
broom 未知	翻译出错，请更新
brooms 未知	翻译出错，请更新
brotherclerks 未知	翻译出错，请更新
brotherly 未知	翻译出错，请更新
browbeats 未知	翻译出错，请更新
browner 未知	翻译出错，请更新
bruises 未知	翻译出错，请更新
brush 未知	翻译出错，请更新
brusque 未知	翻译出错，请更新
brutal 未知	翻译出错，请更新
brutes 未知	翻译出错，请更新
buckle 未知	翻译出错，请更新
buffer 未知	翻译出错，请更新
building 未知	翻译出错，请更新
bull 未知	翻译出错，请更新
bulldog 未知	翻译出错，请更新
bullied 未知	翻译出错，请更新
bullies 未知	翻译出错，请更新
bully 未知	翻译出错，请更新
bulwark 未知	翻译出错，请更新
bulwarks 未知	翻译出错，请更新
bunch 未知	翻译出错，请更新
bungled 未知	翻译出错，请更新
buoy 未知	翻译出错，请更新
buoyancy 未知	翻译出错，请更新
buoyed 未知	翻译出错，请更新
burdensome 未知	翻译出错，请更新
burke 未知	伯克
burn 未知	翻译出错，请更新
burning 未知	翻译出错，请更新
bursting 未知	翻译出错，请更新
bursts 未知	翻译出错，请更新
bustle 未知	翻译出错，请更新
butcher 未知	翻译出错，请更新
butchers 未知	翻译出错，请更新
buttered 未知	翻译出错，请更新
buttonhole 未知	翻译出错，请更新
buttonholed 未知	翻译出错，请更新
byword 未知	翻译出错，请更新
cabbages 未知	翻译出错，请更新
cabinet 未知	翻译出错，请更新
cabs 未知	翻译出错，请更新
calculating 未知	翻译出错，请更新
calendar 未知	翻译出错，请更新
calibre 未知	翻译出错，请更新
caller 未知	翻译出错，请更新
candles 未知	翻译出错，请更新
cantankerous 未知	翻译出错，请更新
cantered 未知	翻译出错，请更新
canvas 未知	翻译出错，请更新
canvassing 未知	翻译出错，请更新
capability 未知	翻译出错，请更新
capitalists 未知	翻译出错，请更新
capitals 未知	翻译出错，请更新
caprice 未知	翻译出错，请更新
capricious 未知	翻译出错，请更新
captains 未知	翻译出错，请更新
captive 未知	翻译出错，请更新
captivity 未知	翻译出错，请更新
carcass 未知	翻译出错，请更新
caressed 未知	翻译出错，请更新
carpet 未知	翻译出错，请更新
carter 未知	翻译出错，请更新
carved 未知	翻译出错，请更新
castaway 未知	翻译出错，请更新
castles 未知	翻译出错，请更新
casual 未知	翻译出错，请更新
cataracts 未知	翻译出错，请更新
catches 未知	翻译出错，请更新
catching 未知	翻译出错，请更新
cattle 未知	翻译出错，请更新
caustic 未知	翻译出错，请更新
cautions 未知	翻译出错，请更新
cautiously 未知	翻译出错，请更新
caves 未知	翻译出错，请更新
cavil 未知	翻译出错，请更新
ceases 未知	翻译出错，请更新
celebrated 未知	翻译出错，请更新
celerity 未知	翻译出错，请更新
celestial 未知	翻译出错，请更新
cementing 未知	翻译出错，请更新
censures 未知	翻译出错，请更新
cent 未知	翻译出错，请更新
centuries 未知	翻译出错，请更新
ceremonies 未知	翻译出错，请更新
chagrin 未知	翻译出错，请更新
chagrined 未知	翻译出错，请更新
chained 未知	翻译出错，请更新
chairman 未知	翻译出错，请更新
cham 未知	翻译出错，请更新
champions 未知	翻译出错，请更新
chap 未知	翻译出错，请更新
characteristic 未知	翻译出错，请更新
charades 未知	翻译出错，请更新
charger 未知	翻译出错，请更新
charges 未知	翻译出错，请更新
chariot 未知	翻译出错，请更新
chariots 未知	翻译出错，请更新
charitable 未知	翻译出错，请更新
charmed 未知	翻译出错，请更新
chat 未知	翻译出错，请更新
cheats 未知	翻译出错，请更新
checking 未知	翻译出错，请更新
cheek 未知	翻译出错，请更新
cheer 未知	翻译出错，请更新
cheerfully 未知	翻译出错，请更新
cheeriest 未知	翻译出错，请更新
cheques 未知	翻译出错，请更新
cherished 未知	翻译出错，请更新
cherrybrandy 未知	翻译出错，请更新
chested 未知	翻译出错，请更新
chickens 未知	翻译出错，请更新
childs 未知	翻译出错，请更新
chilled 未知	翻译出错，请更新
chimerical 未知	翻译出错，请更新
chimneypiece 未知	翻译出错，请更新
chivalrous 未知	翻译出错，请更新
chivalrously 未知	翻译出错，请更新
chop 未知	翻译出错，请更新
chronicler 未知	翻译出错，请更新
churches 未知	翻译出错，请更新
churchtime 未知	翻译出错，请更新
cigars 未知	翻译出错，请更新
circulated 未知	翻译出错，请更新
circumlocution 未知	翻译出错，请更新
circumstanced 未知	翻译出错，请更新
cities 未知	翻译出错，请更新
civilised 未知	翻译出错，请更新
civillyworded 未知	翻译出错，请更新
clad 未知	翻译出错，请更新
claimants 未知	翻译出错，请更新
claiming 未知	翻译出错，请更新
clambered 未知	翻译出错，请更新
clamoured 未知	翻译出错，请更新
clapping 未知	翻译出错，请更新
claptrap 未知	翻译出错，请更新
clasping 未知	翻译出错，请更新
classically 未知	翻译出错，请更新
claws 未知	翻译出错，请更新
cleansing 未知	翻译出错，请更新
clearer 未知	翻译出错，请更新
clearheaded 未知	翻译出错，请更新
clearspoken 未知	翻译出错，请更新
clergyman 未知	翻译出错，请更新
clergymans 未知	翻译出错，请更新
cleverly 未知	翻译出错，请更新
cleverness 未知	翻译出错，请更新
clicking 未知	翻译出错，请更新
client 未知	翻译出错，请更新
climbed 未知	翻译出错，请更新
clinging 未知	翻译出错，请更新
clings 未知	翻译出错，请更新
clipped 未知	翻译出错，请更新
cloak 未知	翻译出错，请更新
cloakroom 未知	翻译出错，请更新
cloaks 未知	翻译出错，请更新
clocktower 未知	翻译出错，请更新
clog 未知	翻译出错，请更新
closest 未知	翻译出错，请更新
closeted 未知	翻译出错，请更新
closing 未知	翻译出错，请更新
cloth 未知	翻译出错，请更新
clue 未知	翻译出错，请更新
clumsy 未知	翻译出错，请更新
cluster 未知	翻译出错，请更新
clustered 未知	翻译出错，请更新
clustering 未知	翻译出错，请更新
coaches 未知	翻译出错，请更新
coalporter 未知	翻译出错，请更新
coals 未知	翻译出错，请更新
coarse 未知	翻译出错，请更新
coast 未知	翻译出错，请更新
cock 未知	翻译出错，请更新
coerce 未知	翻译出错，请更新
coffee 未知	翻译出错，请更新
coffers 未知	翻译出错，请更新
coined 未知	翻译出错，请更新
coldlooking 未知	翻译出错，请更新
coldness 未知	翻译出错，请更新
collarbone 未知	翻译出错，请更新
collect 未知	翻译出错，请更新
collection 未知	翻译出错，请更新
colonel 未知	翻译出错，请更新
colonial 未知	翻译出错，请更新
colony 未知	翻译出错，请更新
colt 未知	翻译出错，请更新
combatants 未知	翻译出错，请更新
combating 未知	翻译出错，请更新
combative 未知	翻译出错，请更新
combats 未知	翻译出错，请更新
combined 未知	翻译出错，请更新
comedy 未知	翻译出错，请更新
comely 未知	翻译出错，请更新
comforters 未知	翻译出错，请更新
comforting 未知	翻译出错，请更新
comforts 未知	翻译出错，请更新
comic 未知	翻译出错，请更新
comings 未知	翻译出错，请更新
commanding 未知	翻译出错，请更新
commendations 未知	翻译出错，请更新
comment 未知	翻译出错，请更新
comments 未知	翻译出错，请更新
commiseration 未知	翻译出错，请更新
commissariat 未知	翻译出错，请更新
commoners 未知	翻译出错，请更新
commonplace 未知	翻译出错，请更新
commonwealth 未知	翻译出错，请更新
communications 未知	翻译出错，请更新
communion 未知	翻译出错，请更新
community 未知	翻译出错，请更新
compactness 未知	翻译出错，请更新
comparison 未知	翻译出错，请更新
comparisons 未知	翻译出错，请更新
compartments 未知	翻译出错，请更新
compel 未知	翻译出错，请更新
compensate 未知	翻译出错，请更新
competent 未知	翻译出错，请更新
competition 未知	翻译出错，请更新
complains 未知	翻译出错，请更新
complaisant 未知	翻译出错，请更新
complement 未知	翻译出错，请更新
completion 未知	翻译出错，请更新
complied 未知	翻译出错，请更新
complimentary 未知	翻译出错，请更新
complimenting 未知	翻译出错，请更新
composing 未知	翻译出错，请更新
compressed 未知	翻译出错，请更新
compressibility 未知	翻译出错，请更新
compromise 未知	翻译出错，请更新
compromises 未知	翻译出错，请更新
compromising 未知	翻译出错，请更新
concede 未知	翻译出错，请更新
concerning 未知	翻译出错，请更新
conciliatory 未知	翻译出错，请更新
conclusions 未知	翻译出错，请更新
concocting 未知	翻译出错，请更新
condemning 未知	翻译出错，请更新
condole 未知	翻译出错，请更新
condolement 未知	翻译出错，请更新
condoned 未知	翻译出错，请更新
conduce 未知	翻译出错，请更新
conducive 未知	翻译出错，请更新
conducting 未知	翻译出错，请更新
confers 未知	翻译出错，请更新
confidante 未知	翻译出错，请更新
confident 未知	翻译出错，请更新
confidentially 未知	翻译出错，请更新
confinement 未知	翻译出错，请更新
confines 未知	翻译出错，请更新
conflict 未知	翻译出错，请更新
conform 未知	翻译出错，请更新
conjunction 未知	翻译出错，请更新
connecting 未知	翻译出错，请更新
connections 未知	翻译出错，请更新
conqueror 未知	翻译出错，请更新
conquest 未知	翻译出错，请更新
consenting 未知	翻译出错，请更新
consents 未知	翻译出错，请更新
conservatory 未知	翻译出错，请更新
considerate 未知	翻译出错，请更新
considers 未知	翻译出错，请更新
consist 未知	翻译出错，请更新
consolations 未知	翻译出错，请更新
console 未知	翻译出错，请更新
consort 未知	翻译出错，请更新
constable 未知	翻译出错，请更新
constituent 未知	翻译出错，请更新
constituted 未知	翻译出错，请更新
constitutes 未知	翻译出错，请更新
constitution 未知	翻译出错，请更新
constraint 未知	翻译出错，请更新
construct 未知	翻译出错，请更新
consultations 未知	翻译出错，请更新
consummate 未知	翻译出错，请更新
contained 未知	翻译出错，请更新
containing 未知	翻译出错，请更新
contemplated 未知	翻译出错，请更新
contemplation 未知	翻译出错，请更新
contemptible 未知	翻译出错，请更新
contenting 未知	翻译出错，请更新
contents 未知	翻译出错，请更新
conterminate 未知	翻译出错，请更新
contested 未知	翻译出错，请更新
contesting 未知	翻译出错，请更新
continuation 未知	翻译出错，请更新
continuous 未知	翻译出错，请更新
contracted 未知	翻译出错，请更新
contradiction 未知	翻译出错，请更新
contrast 未知	翻译出错，请更新
contrasted 未知	翻译出错，请更新
contribute 未知	翻译出错，请更新
contributed 未知	翻译出错，请更新
contributes 未知	翻译出错，请更新
contumely 未知	翻译出错，请更新
conveniently 未知	翻译出错，请更新
conventions 未知	翻译出错，请更新
conversant 未知	翻译出错，请更新
conversational 未知	翻译出错，请更新
conversations 未知	翻译出错，请更新
converse 未知	翻译出错，请更新
conversed 未知	翻译出错，请更新
conversing 未知	翻译出错，请更新
conveying 未知	翻译出错，请更新
convict 未知	翻译出错，请更新
convivial 未知	翻译出错，请更新
cooled 未知	翻译出错，请更新
cooler 未知	翻译出错，请更新
copybooks 未知	翻译出错，请更新
cordial 未知	翻译出错，请更新
core 未知	翻译出错，请更新
corners 未知	翻译出错，请更新
coroners 未知	翻译出错，请更新
corporation 未知	翻译出错，请更新
corrected 未知	翻译出错，请更新
correctness 未知	翻译出错，请更新
corresponded 未知	翻译出错，请更新
corrupt 未知	翻译出错，请更新
coughed 未知	翻译出错，请更新
councillor 未知	翻译出错，请更新
councillors 未知	翻译出错，请更新
counsellors 未知	翻译出错，请更新
countenanced 未知	翻译出错，请更新
counting 未知	翻译出错，请更新
countinghouse 未知	翻译出错，请更新
countout 未知	翻译出错，请更新
countrymans 未知	翻译出错，请更新
countrywoman 未知	翻译出错，请更新
courteousness 未知	翻译出错，请更新
courtesies 未知	翻译出错，请更新
courts 未知	翻译出错，请更新
covers 未知	翻译出错，请更新
covetous 未知	翻译出错，请更新
cowardly 未知	翻译出错，请更新
cracked 未知	翻译出错，请更新
craft 未知	翻译出错，请更新
crag 未知	翻译出错，请更新
crags 未知	翻译出错，请更新
crash 未知	翻译出错，请更新
craving 未知	翻译出错，请更新
creamy 未知	翻译出错，请更新
creates 未知	翻译出错，请更新
creation 未知	翻译出错，请更新
credible 未知	翻译出错，请更新
creditor 未知	翻译出错，请更新
creditors 未知	翻译出错，请更新
crib 未知	翻译出错，请更新
cries 未知	翻译出错，请更新
crimes 未知	翻译出错，请更新
criminals 未知	翻译出错，请更新
criminate 未知	翻译出错，请更新
crinoline 未知	翻译出错，请更新
cripple 未知	翻译出错，请更新
cripples 未知	翻译出错，请更新
crispy 未知	翻译出错，请更新
critic 未知	翻译出错，请更新
critical 未知	翻译出错，请更新
criticised 未知	翻译出错，请更新
critics 未知	翻译出错，请更新
crossexamined 未知	翻译出错，请更新
crossness 未知	翻译出错，请更新
crotchet 未知	翻译出错，请更新
crowners 未知	翻译出错，请更新
cruelty 未知	翻译出错，请更新
crumb 未知	翻译出错，请更新
crumbled 未知	翻译出错，请更新
cub 未知	翻译出错，请更新
cubhunting 未知	翻译出错，请更新
cudgels 未知	翻译出错，请更新
cue 未知	翻译出错，请更新
cultivated 未知	翻译出错，请更新
cumbrous 未知	翻译出错，请更新
cur 未知	翻译出错，请更新
curate 未知	翻译出错，请更新
curlypated 未知	翻译出错，请更新
currantbushes 未知	翻译出错，请更新
curry 未知	翻译出错，请更新
cursed 未知	翻译出错，请更新
cursing 未知	翻译出错，请更新
curtain 未知	翻译出错，请更新
curtains 未知	翻译出错，请更新
curtsey 未知	翻译出错，请更新
cushion 未知	翻译出错，请更新
customarily 未知	翻译出错，请更新
dahlias 未知	翻译出错，请更新
dainties 未知	翻译出错，请更新
dalliance 未知	翻译出错，请更新
damage 未知	翻译出错，请更新
damnably 未知	翻译出错，请更新
damned 未知	翻译出错，请更新
damsels 未知	翻译出错，请更新
danced 未知	翻译出错，请更新
dances 未知	翻译出错，请更新
darker 未知	翻译出错，请更新
darkest 未知	翻译出错，请更新
darkness 未知	翻译出错，请更新
darlings 未知	翻译出错，请更新
dashed 未知	翻译出错，请更新
dastard 未知	翻译出错，请更新
daymail 未知	翻译出错，请更新
dazed 未知	翻译出错，请更新
deadlock 未知	翻译出错，请更新
dealing 未知	翻译出错，请更新
dealt 未知	翻译出错，请更新
deanery 未知	翻译出错，请更新
deaths 未知	翻译出错，请更新
decanters 未知	翻译出错，请更新
decanting 未知	翻译出错，请更新
deceit 未知	翻译出错，请更新
deceive 未知	翻译出错，请更新
deceiving 未知	翻译出错，请更新
decencies 未知	翻译出错，请更新
decently 未知	翻译出错，请更新
decidedly 未知	翻译出错，请更新
deck 未知	翻译出错，请更新
declares 未知	翻译出错，请更新
declines 未知	翻译出错，请更新
decorated 未知	翻译出错，请更新
decorations 未知	翻译出错，请更新
decorum 未知	翻译出错，请更新
decrease 未知	翻译出错，请更新
decreased 未知	翻译出错，请更新
deference 未知	翻译出错，请更新
deferred 未知	翻译出错，请更新
deficiency 未知	翻译出错，请更新
define 未知	翻译出错，请更新
definite 未知	翻译出错，请更新
defrayed 未知	翻译出错，请更新
defy 未知	翻译出错，请更新
delaying 未知	翻译出错，请更新
deliberate 未知	翻译出错，请更新
delicately 未知	翻译出错，请更新
delirium 未知	翻译出错，请更新
delivering 未知	翻译出错，请更新
demanding 未知	翻译出错，请更新
demands 未知	翻译出错，请更新
demerit 未知	翻译出错，请更新
demigod 未知	翻译出错，请更新
demonstrate 未知	翻译出错，请更新
demurely 未知	翻译出错，请更新
denial 未知	翻译出错，请更新
denies 未知	翻译出错，请更新
denote 未知	翻译出错，请更新
denouncing 未知	翻译出错，请更新
denunciations 未知	翻译出错，请更新
departing 未知	翻译出错，请更新
deplored 未知	翻译出错，请更新
depositary 未知	翻译出错，请更新
deprecate 未知	翻译出错，请更新
depreciate 未知	翻译出错，请更新
depression 未知	翻译出错，请更新
deprived 未知	翻译出错，请更新
depth 未知	翻译出错，请更新
derision 未知	翻译出错，请更新
derived 未知	翻译出错，请更新
derogate 未知	翻译出错，请更新
descendant 未知	翻译出错，请更新
descending 未知	翻译出错，请更新
descent 未知	翻译出错，请更新
deserting 未知	翻译出错，请更新
designated 未知	翻译出错，请更新
desisted 未知	翻译出错，请更新
despatchboxes 未知	翻译出错，请更新
despatched 未知	翻译出错，请更新
desperate 未知	翻译出错，请更新
despising 未知	翻译出错，请更新
despotic 未知	翻译出错，请更新
destined 未知	翻译出错，请更新
destiny 未知	翻译出错，请更新
destruction 未知	翻译出错，请更新
destructive 未知	翻译出错，请更新
detailing 未知	翻译出错，请更新
detention 未知	翻译出错，请更新
determinate 未知	翻译出错，请更新
determination 未知	翻译出错，请更新
determine 未知	翻译出错，请更新
detest 未知	翻译出错，请更新
detestable 未知	翻译出错，请更新
detested 未知	翻译出错，请更新
detriment 未知	翻译出错，请更新
deuced 未知	翻译出错，请更新
devilled 未知	翻译出错，请更新
devoid 未知	翻译出错，请更新
devolve 未知	翻译出错，请更新
devote 未知	翻译出错，请更新
devoting 未知	翻译出错，请更新
devotions 未知	翻译出错，请更新
devour 未知	翻译出错，请更新
devoured 未知	翻译出错，请更新
diamonds 未知	翻译出错，请更新
dice 未知	翻译出错，请更新
dictated 未知	翻译出错，请更新
dictates 未知	翻译出错，请更新
dictatorial 未知	翻译出错，请更新
dies 未知	翻译出错，请更新
differ 未知	翻译出错，请更新
differed 未知	翻译出错，请更新
digestion 未知	翻译出错，请更新
diggings 未知	翻译出错，请更新
dignitary 未知	翻译出错，请更新
diligently 未知	翻译出错，请更新
dimensions 未知	翻译出错，请更新
diminished 未知	翻译出错，请更新
diningout 未知	翻译出错，请更新
dinnertable 未知	翻译出错，请更新
diocese 未知	翻译出错，请更新
dioceses 未知	翻译出错，请更新
diplomatic 未知	翻译出错，请更新
disadvantage 未知	翻译出错，请更新
disadvantageous 未知	翻译出错，请更新
disagreeably 未知	翻译出错，请更新
disallowed 未知	翻译出错，请更新
disappointments 未知	翻译出错，请更新
disapprove 未知	翻译出错，请更新
disbelieve 未知	翻译出错，请更新
disbelieved 未知	翻译出错，请更新
discern 未知	翻译出错，请更新
disciple 未知	翻译出错，请更新
disclosed 未知	翻译出错，请更新
discomforts 未知	翻译出错，请更新
disconsolate 未知	翻译出错，请更新
discounted 未知	翻译出错，请更新
discounter 未知	翻译出错，请更新
discoursing 未知	翻译出错，请更新
discover 未知	翻译出错，请更新
discreetly 未知	翻译出错，请更新
disdain 未知	翻译出错，请更新
disdainful 未知	翻译出错，请更新
disdaining 未知	翻译出错，请更新
disembarrassed 未知	翻译出错，请更新
disenfranchise 未知	翻译出错，请更新
disengaged 未知	翻译出错，请更新
disfigure 未知	翻译出错，请更新
disfranchising 未知	翻译出错，请更新
disgracefully 未知	翻译出错，请更新
disgusting 未知	翻译出错，请更新
dishonestly 未知	翻译出错，请更新
dishonour 未知	翻译出错，请更新
disinterested 未知	翻译出错，请更新
dislikings 未知	翻译出错，请更新
dismiss 未知	翻译出错，请更新
dismissed 未知	翻译出错，请更新
disobedience 未知	翻译出错，请更新
disobey 未知	翻译出错，请更新
disparity 未知	翻译出错，请更新
dispassionate 未知	翻译出错，请更新
dispelling 未知	翻译出错，请更新
dispense 未知	翻译出错，请更新
dispensed 未知	翻译出错，请更新
dispenser 未知	翻译出错，请更新
dispirited 未知	翻译出错，请更新
displayed 未知	翻译出错，请更新
displease 未知	翻译出错，请更新
dispose 未知	翻译出错，请更新
disputes 未知	翻译出错，请更新
disregarding 未知	翻译出错，请更新
disrespectful 未知	翻译出错，请更新
disrespectfully 未知	翻译出错，请更新
disseminate 未知	翻译出错，请更新
dissent 未知	翻译出错，请更新
dissipated 未知	翻译出错，请更新
dissipation 未知	翻译出错，请更新
dissolving 未知	翻译出错，请更新
dissuade 未知	翻译出错，请更新
dissuaded 未知	翻译出错，请更新
distaff 未知	翻译出错，请更新
distilleries 未知	翻译出错，请更新
distinctly 未知	翻译出错，请更新
distinguish 未知	翻译出错，请更新
distinguished 未知	翻译出错，请更新
distractions 未知	翻译出错，请更新
distribution 未知	翻译出错，请更新
disunion 未知	翻译出错，请更新
ditches 未知	翻译出错，请更新
dive 未知	翻译出错，请更新
divergence 未知	翻译出错，请更新
diversion 未知	翻译出错，请更新
divert 未知	翻译出错，请更新
divinities 未知	翻译出错，请更新
divinity 未知	翻译出错，请更新
dockyards 未知	翻译出错，请更新
doctoring 未知	翻译出错，请更新
document 未知	翻译出错，请更新
dolt 未知	翻译出错，请更新
domestics 未知	翻译出错，请更新
domiciliary 未知	翻译出错，请更新
donkeys 未知	翻译出错，请更新
doomed 未知	翻译出错，请更新
doorkeeper 未知	翻译出错，请更新
doorkeepers 未知	翻译出错，请更新
doorpost 未知	翻译出错，请更新
dooty 未知	翻译出错，请更新
doses 未知	翻译出错，请更新
dowager 未知	翻译出错，请更新
downfall 未知	翻译出错，请更新
downhearted 未知	翻译出错，请更新
downwards 未知	翻译出错，请更新
dpt 未知	翻译出错，请更新
drafting 未知	翻译出错，请更新
draftsman 未知	翻译出错，请更新
draftsmans 未知	翻译出错，请更新
dragged 未知	翻译出错，请更新
dragging 未知	翻译出错，请更新
dragons 未知	翻译出错，请更新
drags 未知	翻译出错，请更新
drained 未知	翻译出错，请更新
drakes 未知	翻译出错，请更新
drapery 未知	翻译出错，请更新
drawbacks 未知	翻译出错，请更新
drawer 未知	翻译出错，请更新
drawing 未知	翻译出错，请更新
dreaded 未知	翻译出错，请更新
dreamy 未知	翻译出错，请更新
dreariest 未知	翻译出错，请更新
dreariness 未知	翻译出错，请更新
drift 未知	翻译出错，请更新
drifting 未知	翻译出错，请更新
drily 未知	翻译出错，请更新
driver 未知	翻译出错，请更新
drollery 未知	翻译出错，请更新
drones 未知	翻译出错，请更新
drover 未知	翻译出错，请更新
drug 未知	翻译出错，请更新
drunkenness 未知	翻译出错，请更新
dsespoir 未知	翻译出错，请更新
dual 未知	翻译出错，请更新
ducal 未知	翻译出错，请更新
ducks 未知	翻译出错，请更新
durable 未知	翻译出错，请更新
durance 未知	翻译出错，请更新
dusk 未知	翻译出错，请更新
dusted 未知	翻译出错，请更新
dutiful 未知	翻译出错，请更新
dutys 未知	翻译出错，请更新
dwell 未知	翻译出错，请更新
dwellers 未知	翻译出错，请更新
dying 未知	翻译出错，请更新
dyou 未知	翻译出错，请更新
dyspepsia 未知	翻译出错，请更新
earthly 未知	翻译出错，请更新
easiness 未知	翻译出错，请更新
eater 未知	翻译出错，请更新
eccentric 未知	翻译出错，请更新
ecstasy 未知	翻译出错，请更新
ecstatic 未知	翻译出错，请更新
edge 未知	翻译出错，请更新
edition 未知	翻译出错，请更新
educational 未知	翻译出错，请更新
efficient 未知	翻译出错，请更新
egg 未知	翻译出错，请更新
egregiously 未知	翻译出错，请更新
eightandtwenty 未知	翻译出错，请更新
eighteen 未知	翻译出错，请更新
eighty 未知	翻译出错，请更新
elastic 未知	翻译出错，请更新
elbowed 未知	翻译出错，请更新
elbows 未知	翻译出错，请更新
elderly 未知	翻译出错，请更新
electing 未知	翻译出错，请更新
elicit 未知	翻译出错，请更新
elongation 未知	翻译出错，请更新
elude 未知	翻译出错，请更新
elysium 未知	翻译出错，请更新
emanations 未知	翻译出错，请更新
emancipating 未知	翻译出错，请更新
embarkation 未知	翻译出错，请更新
embarrassed 未知	翻译出错，请更新
embarrassing 未知	翻译出错，请更新
embitter 未知	翻译出错，请更新
emergencies 未知	翻译出错，请更新
emigrant 未知	翻译出错，请更新
emitted 未知	翻译出错，请更新
emotion 未知	翻译出错，请更新
employers 未知	翻译出错，请更新
emptyheaded 未知	翻译出错，请更新
en 未知	翻译出错，请更新
encompassed 未知	翻译出错，请更新
encountering 未知	翻译出错，请更新
encounters 未知	翻译出错，请更新
encourage 未知	翻译出错，请更新
endangered 未知	翻译出错，请更新
endangering 未知	翻译出错，请更新
endeavours 未知	翻译出错，请更新
endless 未知	翻译出错，请更新
endowments 未知	翻译出错，请更新
energies 未知	翻译出错，请更新
enervating 未知	翻译出错，请更新
engendering 未知	翻译出错，请更新
engrossed 未知	翻译出错，请更新
engrossing 未知	翻译出错，请更新
enjoying 未知	翻译出错，请更新
enlargement 未知	翻译出错，请更新
enlightened 未知	翻译出错，请更新
enlist 未知	翻译出错，请更新
enlivening 未知	翻译出错，请更新
enormous 未知	翻译出错，请更新
ensured 未知	翻译出错，请更新
entail 未知	翻译出错，请更新
entertainments 未知	翻译出错，请更新
enthralled 未知	翻译出错，请更新
enthusiastic 未知	翻译出错，请更新
entirety 未知	翻译出错，请更新
entrancing 未知	翻译出错，请更新
entrust 未知	翻译出错，请更新
episodes 未知	翻译出错，请更新
epistle 未知	翻译出错，请更新
epithet 未知	翻译出错，请更新
equestrians 未知	翻译出错，请更新
ere 未知	翻译出错，请更新
erection 未知	翻译出错，请更新
erotic 未知	翻译出错，请更新
errand 未知	翻译出错，请更新
erred 未知	翻译出错，请更新
escaping 未知	翻译出错，请更新
eschew 未知	翻译出错，请更新
escorted 未知	翻译出错，请更新
essayed 未知	翻译出错，请更新
essential 未知	翻译出错，请更新
establishing 未知	翻译出错，请更新
establishment 未知	翻译出错，请更新
estimable 未知	翻译出错，请更新
estimate 未知	翻译出错，请更新
estimates 未知	翻译出错，请更新
estrangement 未知	翻译出错，请更新
eternal 未知	翻译出错，请更新
eulogium 未知	翻译出错，请更新
evanescent 未知	翻译出错，请更新
evergreens 未知	翻译出错，请更新
everlastingly 未知	翻译出错，请更新
evermoving 未知	翻译出错，请更新
evils 未知	翻译出错，请更新
evinced 未知	翻译出错，请更新
evolve 未知	翻译出错，请更新
exacting 未知	翻译出错，请更新
exactness 未知	翻译出错，请更新
exaggerated 未知	翻译出错，请更新
exaggeration 未知	翻译出错，请更新
exalt 未知	翻译出错，请更新
examine 未知	翻译出错，请更新
example 未知	翻译出错，请更新
examples 未知	翻译出错，请更新
exceeding 未知	翻译出错，请更新
excellently 未知	翻译出错，请更新
excitable 未知	翻译出错，请更新
excite 未知	翻译出错，请更新
exciting 未知	翻译出错，请更新
exclaim 未知	翻译出错，请更新
excluded 未知	翻译出错，请更新
excluding 未知	翻译出错，请更新
exclusion 未知	翻译出错，请更新
executive 未知	翻译出错，请更新
executors 未知	翻译出错，请更新
exert 未知	翻译出错，请更新
exerted 未知	翻译出错，请更新
exertions 未知	翻译出错，请更新
exhibit 未知	翻译出错，请更新
exhibition 未知	翻译出错，请更新
exigeant 未知	翻译出错，请更新
exist 未知	翻译出错，请更新
exorcised 未知	翻译出错，请更新
expanse 未知	翻译出错，请更新
expects 未知	翻译出错，请更新
expedition 未知	翻译出错，请更新
expend 未知	翻译出错，请更新
expended 未知	翻译出错，请更新
expensive 未知	翻译出错，请更新
experienced 未知	翻译出错，请更新
expiring 未知	翻译出错，请更新
explains 未知	翻译出错，请更新
exponent 未知	翻译出错，请更新
expresses 未知	翻译出错，请更新
extinction 未知	翻译出错，请更新
extinguish 未知	翻译出错，请更新
extracted 未知	翻译出错，请更新
extravagance 未知	翻译出错，请更新
extravagant 未知	翻译出错，请更新
extravagantly 未知	翻译出错，请更新
extreme 未知	翻译出错，请更新
extremely 未知	翻译出错，请更新
extricated 未知	翻译出错，请更新
extricating 未知	翻译出错，请更新
exultant 未知	翻译出错，请更新
exultation 未知	翻译出错，请更新
eyebrow 未知	翻译出错，请更新
eyelids 未知	翻译出错，请更新
fa 未知	翻译出错，请更新
fabric 未知	翻译出错，请更新
fabricated 未知	翻译出错，请更新
facing 未知	翻译出错，请更新
facings 未知	翻译出错，请更新
faded 未知	翻译出错，请更新
fain 未知	翻译出错，请更新
fairest 未知	翻译出错，请更新
fairhaired 未知	翻译出错，请更新
fairness 未知	翻译出错，请更新
faithlessness 未知	翻译出错，请更新
families 未知	翻译出错，请更新
famine 未知	翻译出错，请更新
fancying 未知	翻译出错，请更新
fantastic 未知	翻译出错，请更新
faradvanced 未知	翻译出错，请更新
fare 未知	翻译出错，请更新
fared 未知	翻译出错，请更新
farmyard 未知	翻译出错，请更新
fascinating 未知	翻译出错，请更新
fashioned 未知	翻译出错，请更新
fastest 未知	翻译出错，请更新
fatally 未知	翻译出错，请更新
fatigued 未知	翻译出错，请更新
fatuous 未知	翻译出错，请更新
favourably 未知	翻译出错，请更新
favours 未知	翻译出错，请更新
fed 未知	翻译出错，请更新
fee 未知	翻译出错，请更新
feed 未知	翻译出错，请更新
feeds 未知	翻译出错，请更新
fees 未知	翻译出错，请更新
feigning 未知	翻译出错，请更新
felicity 未知	翻译出错，请更新
fellowcommoners 未知	翻译出错，请更新
fellowll 未知	翻译出错，请更新
fellowtownsmen 未知	翻译出错，请更新
females 未知	翻译出错，请更新
fever 未知	翻译出错，请更新
fevers 未知	翻译出错，请更新
fewer 未知	翻译出错，请更新
fewest 未知	翻译出错，请更新
fiddlers 未知	翻译出错，请更新
fidelity 未知	翻译出错，请更新
fiend 未知	翻译出错，请更新
fiendish 未知	翻译出错，请更新
fifteenth 未知	翻译出错，请更新
fights 未知	翻译出错，请更新
figments 未知	翻译出错，请更新
filtered 未知	翻译出错，请更新
finances 未知	翻译出错，请更新
finely 未知	翻译出错，请更新
fingering 未知	翻译出错，请更新
firearms 未知	翻译出错，请更新
fireplace 未知	翻译出错，请更新
fires 未知	翻译出错，请更新
firing 未知	翻译出错，请更新
firmness 未知	翻译出错，请更新
firstfloor 未知	翻译出错，请更新
fiveandthirty 未知	翻译出错，请更新
fix 未知	翻译出错，请更新
flageolet 未知	翻译出错，请更新
flatteries 未知	翻译出错，请更新
flattery 未知	翻译出错，请更新
flavoured 未知	翻译出错，请更新
fleeced 未知	翻译出错，请更新
flick 未知	翻译出错，请更新
flight 未知	翻译出错，请更新
flimsy 未知	翻译出错，请更新
flinging 未知	翻译出错，请更新
flippancy 未知	翻译出错，请更新
flirtation 未知	翻译出错，请更新
flitted 未知	翻译出错，请更新
float 未知	翻译出错，请更新
flocked 未知	翻译出错，请更新
flounced 未知	翻译出错，请更新
flowing 未知	翻译出错，请更新
fluctuated 未知	翻译出错，请更新
flukes 未知	翻译出错，请更新
fluttered 未知	翻译出错，请更新
flying 未知	翻译出错，请更新
folded 未知	翻译出错，请更新
folio 未知	翻译出错，请更新
folks 未知	翻译出错，请更新
follies 未知	翻译出错，请更新
follower 未知	翻译出错，请更新
foolishness 未知	翻译出错，请更新
footfall 未知	翻译出错，请更新
footground 未知	翻译出错，请更新
footstools 未知	翻译出错，请更新
forbearance 未知	翻译出错，请更新
forbearing 未知	翻译出错，请更新
forces 未知	翻译出错，请更新
forcible 未知	翻译出错，请更新
forcibly 未知	翻译出错，请更新
forcing 未知	翻译出错，请更新
forefinger 未知	翻译出错，请更新
forego 未知	翻译出错，请更新
foremost 未知	翻译出错，请更新
foresee 未知	翻译出错，请更新
forestalling 未知	翻译出错，请更新
foresttrees 未知	翻译出错，请更新
forgave 未知	翻译出错，请更新
forger 未知	翻译出错，请更新
forgetful 未知	翻译出错，请更新
forgets 未知	翻译出错，请更新
forgives 未知	翻译出错，请更新
formae 未知	翻译出错，请更新
formally 未知	翻译出错，请更新
fortified 未知	翻译出错，请更新
fortifying 未知	翻译出错，请更新
fortunately 未知	翻译出错，请更新
fortunes 未知	翻译出错，请更新
fortyfive 未知	翻译出错，请更新
fortyseven 未知	翻译出错，请更新
forwards 未知	翻译出错，请更新
fostered 未知	翻译出错，请更新
foundations 未知	翻译出错，请更新
fountain 未知	翻译出错，请更新
fourandtwenty 未知	翻译出错，请更新
fourfifths 未知	翻译出错，请更新
foursided 未知	翻译出错，请更新
fourths 未知	翻译出错，请更新
fouryearold 未知	翻译出错，请更新
fowl 未知	翻译出错，请更新
foxhound 未知	翻译出错，请更新
fraction 未知	翻译出错，请更新
fractions 未知	翻译出错，请更新
fragments 未知	翻译出错，请更新
frail 未知	翻译出错，请更新
frankness 未知	翻译出错，请更新
fraternal 未知	翻译出错，请更新
fraught 未知	翻译出错，请更新
frequenters 未知	翻译出错，请更新
fret 未知	翻译出错，请更新
frighten 未知	翻译出错，请更新
frightens 未知	翻译出错，请更新
frigid 未知	翻译出错，请更新
frittering 未知	翻译出错，请更新
frivolous 未知	翻译出错，请更新
frivolously 未知	翻译出错，请更新
frolic 未知	翻译出错，请更新
frowns 未知	翻译出错，请更新
frozen 未知	翻译出错，请更新
fruitful 未知	翻译出错，请更新
fruition 未知	翻译出错，请更新
fruitless 未知	翻译出错，请更新
fte 未知	翻译出错，请更新
fted 未知	翻译出错，请更新
fuller 未知	翻译出错，请更新
fullness 未知	翻译出错，请更新
fume 未知	翻译出错，请更新
fumed 未知	翻译出错，请更新
fund 未知	翻译出错，请更新
fungus 未知	翻译出错，请更新
funk 未知	翻译出错，请更新
furs 未知	翻译出错，请更新
furtherance 未知	翻译出错，请更新
furtively 未知	翻译出错，请更新
fury 未知	翻译出错，请更新
fuss 未知	翻译出错，请更新
fussed 未知	翻译出错，请更新
fussy 未知	翻译出错，请更新
futile 未知	翻译出错，请更新
gaieties 未知	翻译出错，请更新
gainers 未知	翻译出错，请更新
galling 未知	翻译出错，请更新
gallipots 未知	翻译出错，请更新
gallop 未知	翻译出错，请更新
gamble 未知	翻译出错，请更新
gambled 未知	翻译出错，请更新
gambler 未知	翻译出错，请更新
gamekeeper 未知	翻译出错，请更新
gap 未知	翻译出错，请更新
garrets 未知	翻译出错，请更新
garrotter 未知	翻译出错，请更新
garter 未知	吊袜带
gas 未知	翻译出错，请更新
gaslamps 未知	翻译出错，请更新
gastric 未知	翻译出错，请更新
gather 未知	翻译出错，请更新
gaudy 未知	翻译出错，请更新
gaugers 未知	翻译出错，请更新
gaunt 未知	翻译出错，请更新
gauntlet 未知	翻译出错，请更新
gay 未知	翻译出错，请更新
gazing 未知	翻译出错，请更新
generals 未知	翻译出错，请更新
generation 未知	翻译出错，请更新
generously 未知	翻译出错，请更新
genlemen 未知	翻译出错，请更新
genteel 未知	翻译出错，请更新
gentility 未知	翻译出错，请更新
gentlemanlike 未知	翻译出错，请更新
gentry 未知	翻译出错，请更新
gesticulation 未知	翻译出错，请更新
gilding 未知	翻译出错，请更新
gipsy 未知	翻译出错，请更新
girdle 未知	翻译出错，请更新
girlish 未知	翻译出错，请更新
giver 未知	翻译出错，请更新
gladiator 未知	翻译出错，请更新
glanced 未知	翻译出错，请更新
glances 未知	翻译出错，请更新
glaring 未知	翻译出错，请更新
glib 未知	翻译出错，请更新
glimmering 未知	翻译出错，请更新
glimpse 未知	翻译出错，请更新
glitter 未知	翻译出错，请更新
gloomily 未知	翻译出错，请更新
gloss 未知	翻译出错，请更新
glow 未知	翻译出错，请更新
gnash 未知	翻译出错，请更新
godchild 未知	翻译出错，请更新
goers 未知	翻译出错，请更新
goings 未知	翻译出错，请更新
goods 未知	翻译出错，请更新
gosling 未知	翻译出错，请更新
gossiping 未知	翻译出错，请更新
gotten 未知	翻译出错，请更新
gouty 未知	翻译出错，请更新
govern 未知	翻译出错，请更新
graced 未知	翻译出错，请更新
gracefully 未知	翻译出错，请更新
graces 未知	翻译出错，请更新
gracing 未知	翻译出错，请更新
grandchildren 未知	翻译出错，请更新
grandee 未知	翻译出错，请更新
grandeur 未知	翻译出错，请更新
grandiloquent 未知	翻译出错，请更新
granduncle 未知	翻译出错，请更新
granduncles 未知	翻译出错，请更新
grange 未知	翻译出错，请更新
grasping 未知	翻译出错，请更新
grasses 未知	翻译出错，请更新
grated 未知	翻译出错，请更新
gratify 未知	翻译出错，请更新
gratifying 未知	翻译出错，请更新
grazier 未知	翻译出错，请更新
greatgrandmother 未知	翻译出错，请更新
greatuncle 未知	翻译出错，请更新
greedy 未知	翻译出错，请更新
greensward 未知	翻译出错，请更新
greetings 未知	翻译出错，请更新
gregarious 未知	翻译出错，请更新
grievously 未知	翻译出错，请更新
grim 未知	翻译出错，请更新
grinding 未知	翻译出错，请更新
grotesque 未知	翻译出错，请更新
groundrent 未知	翻译出错，请更新
grouped 未知	翻译出错，请更新
groups 未知	翻译出错，请更新
grouses 未知	翻译出错，请更新
grouseshooting 未知	翻译出错，请更新
growl 未知	翻译出错，请更新
grudge 未知	翻译出错，请更新
gruelled 未知	翻译出错，请更新
grunted 未知	翻译出错，请更新
guessing 未知	翻译出错，请更新
guile 未知	翻译出错，请更新
guineas 未知	翻译出错，请更新
guise 未知	翻译出错，请更新
gull 未知	翻译出错，请更新
gulped 未知	翻译出错，请更新
gusto 未知	翻译出错，请更新
h 未知	翻译出错，请更新
habitually 未知	翻译出错，请更新
hack 未知	翻译出错，请更新
hairs 未知	翻译出错，请更新
halfacrown 未知	翻译出错，请更新
halfadozen 未知	翻译出错，请更新
halfandhalf 未知	翻译出错，请更新
halfasovereign 未知	翻译出错，请更新
halfcrown 未知	翻译出错，请更新
halfdeclared 未知	翻译出错，请更新
halfdisgusted 未知	翻译出错，请更新
halffamiliar 未知	翻译出错，请更新
halfformed 未知	翻译出错，请更新
halfhesitating 未知	翻译出错，请更新
halfholiday 未知	翻译出错，请更新
halfhour 未知	翻译出错，请更新
halfmade 未知	翻译出错，请更新
halfmonkey 未知	翻译出错，请更新
halfpleased 未知	翻译出错，请更新
halfresolved 未知	翻译出错，请更新
halfsavage 未知	翻译出错，请更新
halfsentimental 未知	翻译出错，请更新
halfsuggestion 未知	翻译出错，请更新
halfway 未知	翻译出错，请更新
hallooing 未知	翻译出错，请更新
hallowed 未知	翻译出错，请更新
halo 未知	翻译出错，请更新
halveable 未知	翻译出错，请更新
hamlets 未知	翻译出错，请更新
hampered 未知	翻译出错，请更新
handing 未知	翻译出错，请更新
handled 未知	翻译出错，请更新
handsomely 未知	翻译出错，请更新
handy 未知	翻译出错，请更新
haporth 未知	翻译出错，请更新
harangue 未知	翻译出错，请更新
harass 未知	翻译出错，请更新
hardness 未知	翻译出错，请更新
hardworked 未知	翻译出错，请更新
hardworking 未知	翻译出错，请更新
hardy 未知	翻译出错，请更新
harmonies 未知	翻译出错，请更新
harmonious 未知	翻译出错，请更新
harshest 未知	翻译出错，请更新
haughty 未知	翻译出错，请更新
haul 未知	翻译出错，请更新
haycock 未知	翻译出错，请更新
headlong 未知	翻译出错，请更新
heal 未知	翻译出错，请更新
healthy 未知	翻译出错，请更新
heartless 未知	翻译出错，请更新
heartpiercing 未知	翻译出错，请更新
heartstruggles 未知	翻译出错，请更新
heated 未知	翻译出错，请更新
heave 未知	翻译出错，请更新
heavier 未知	翻译出错，请更新
heaviest 未知	翻译出错，请更新
hedge 未知	翻译出错，请更新
hedges 未知	翻译出错，请更新
heels 未知	翻译出错，请更新
heirs 未知	翻译出错，请更新
heirship 未知	翻译出错，请更新
hem 未知	翻译出错，请更新
herding 未知	翻译出错，请更新
hereabouts 未知	翻译出错，请更新
hereditary 未知	翻译出错，请更新
hereupon 未知	翻译出错，请更新
hermit 未知	翻译出错，请更新
heroes 未知	翻译出错，请更新
herring 未知	翻译出错，请更新
heterodox 未知	翻译出错，请更新
heye 未知	翻译出错，请更新
hidden 未知	翻译出错，请更新
hiding 未知	翻译出错，请更新
highflown 未知	翻译出错，请更新
highgrown 未知	翻译出错，请更新
highlands 未知	翻译出错，请更新
highness 未知	高ness
highspirited 未知	翻译出错，请更新
hills 未知	翻译出错，请更新
hillside 未知	翻译出错，请更新
hind 未知	翻译出错，请更新
hindrance 未知	翻译出错，请更新
hindrances 未知	翻译出错，请更新
hisself 未知	翻译出错，请更新
historical 未知	翻译出错，请更新
hits 未知	翻译出错，请更新
hive 未知	翻译出错，请更新
ho 未知	翻译出错，请更新
hoard 未知	翻译出错，请更新
hoardings 未知	翻译出错，请更新
hoaxing 未知	翻译出错，请更新
hobby 未知	翻译出错，请更新
holepickers 未知	翻译出错，请更新
holepicking 未知	翻译出错，请更新
holiday 未知	翻译出错，请更新
hollow 未知	翻译出错，请更新
homage 未知	翻译出错，请更新
homely 未知	翻译出错，请更新
honestys 未知	翻译出错，请更新
honeyflowing 未知	翻译出错，请更新
honourably 未知	翻译出错，请更新
hook 未知	翻译出错，请更新
hooted 未知	翻译出错，请更新
horgans 未知	翻译出错，请更新
horns 未知	翻译出错，请更新
horribly 未知	翻译出错，请更新
horrified 未知	翻译出错，请更新
horrors 未知	翻译出错，请更新
horseflesh 未知	翻译出错，请更新
horsewhip 未知	翻译出错，请更新
horsewoman 未知	翻译出错，请更新
hospitable 未知	翻译出错，请更新
hospital 未知	翻译出错，请更新
hospitality 未知	翻译出错，请更新
hothouses 未知	翻译出错，请更新
hovered 未知	翻译出错，请更新
hubbub 未知	翻译出错，请更新
hue 未知	翻译出错，请更新
humblest 未知	翻译出错，请更新
humbug 未知	翻译出错，请更新
humour 未知	翻译出错，请更新
hungry 未知	翻译出错，请更新
hunters 未知	翻译出错，请更新
hurriedly 未知	翻译出错，请更新
hushed 未知	翻译出错，请更新
husk 未知	翻译出错，请更新
hustings 未知	翻译出错，请更新
hustled 未知	翻译出错，请更新
hymeneals 未知	翻译出错，请更新
hypocritical 未知	翻译出错，请更新
hysterics 未知	翻译出错，请更新
ideal 未知	翻译出错，请更新
identities 未知	翻译出错，请更新
idlepeople 未知	翻译出错，请更新
idol 未知	翻译出错，请更新
idolatrous 未知	翻译出错，请更新
idolised 未知	翻译出错，请更新
ignisfatuus 未知	翻译出错，请更新
ignoble 未知	翻译出错，请更新
ignominiously 未知	翻译出错，请更新
illbalanced 未知	翻译出错，请更新
illdisposed 未知	翻译出错，请更新
illfortune 未知	翻译出错，请更新
illhealth 未知	翻译出错，请更新
illhumour 未知	翻译出错，请更新
illhumoured 未知	翻译出错，请更新
illtold 未知	翻译出错，请更新
illtreated 未知	翻译出错，请更新
illtreating 未知	翻译出错，请更新
illtreatment 未知	翻译出错，请更新
illtreats 未知	翻译出错，请更新
image 未知	翻译出错，请更新
imagery 未知	翻译出错，请更新
imbecile 未知	翻译出错，请更新
imbue 未知	翻译出错，请更新
imbued 未知	翻译出错，请更新
immensely 未知	翻译出错，请更新
imminent 未知	翻译出错，请更新
immortality 未知	翻译出错，请更新
impairing 未知	翻译出错，请更新
imparting 未知	翻译出错，请更新
impassable 未知	翻译出错，请更新
impassive 未知	翻译出错，请更新
impatience 未知	翻译出错，请更新
impatiently 未知	翻译出错，请更新
impeachment 未知	翻译出错，请更新
impede 未知	翻译出错，请更新
imperfect 未知	翻译出错，请更新
impertinent 未知	翻译出错，请更新
impetus 未知	翻译出错，请更新
implored 未知	翻译出错，请更新
implores 未知	翻译出错，请更新
imploring 未知	翻译出错，请更新
impolitic 未知	翻译出错，请更新
importation 未知	翻译出错，请更新
importunity 未知	翻译出错，请更新
impose 未知	翻译出错，请更新
impractical 未知	翻译出错，请更新
impress 未知	翻译出错，请更新
impressions 未知	翻译出错，请更新
imprisonment 未知	翻译出错，请更新
improbability 未知	翻译出错，请更新
improprieties 未知	翻译出错，请更新
impropriety 未知	翻译出错，请更新
improve 未知	翻译出错，请更新
improving 未知	翻译出错，请更新
impulse 未知	翻译出错，请更新
imputation 未知	翻译出错，请更新
inaction 未知	翻译出错，请更新
inactivity 未知	翻译出错，请更新
inappropriate 未知	翻译出错，请更新
inattention 未知	翻译出错，请更新
inaudible 未知	翻译出错，请更新
inaudibly 未知	翻译出错，请更新
inclination 未知	翻译出错，请更新
including 未知	翻译出错，请更新
incoming 未知	翻译出错，请更新
incompatibility 未知	翻译出错，请更新
incomplete 未知	翻译出错，请更新
inconstant 未知	翻译出错，请更新
inconveniences 未知	翻译出错，请更新
inconvenient 未知	翻译出错，请更新
increasing 未知	翻译出错，请更新
incredible 未知	翻译出错，请更新
incredulously 未知	翻译出错，请更新
incurring 未知	翻译出错，请更新
indebted 未知	翻译出错，请更新
indefeasible 未知	翻译出错，请更新
indefinite 未知	翻译出错，请更新
indefinitely 未知	翻译出错，请更新
indication 未知	翻译出错，请更新
indictment 未知	翻译出错，请更新
indignantly 未知	翻译出错，请更新
indiscreetly 未知	翻译出错，请更新
individuality 未知	翻译出错，请更新
individually 未知	翻译出错，请更新
inducing 未知	翻译出错，请更新
indulgence 未知	翻译出错，请更新
indulges 未知	翻译出错，请更新
indulging 未知	翻译出错，请更新
ineffably 未知	翻译出错，请更新
ineffective 未知	翻译出错，请更新
ineffectual 未知	翻译出错，请更新
ineffectually 未知	翻译出错，请更新
inefficacy 未知	翻译出错，请更新
inequalities 未知	翻译出错，请更新
inestimable 未知	翻译出错，请更新
inexpedient 未知	翻译出错，请更新
infamously 未知	翻译出错，请更新
infamy 未知	翻译出错，请更新
infants 未知	翻译出错，请更新
inferiority 未知	翻译出错，请更新
inflammation 未知	翻译出错，请更新
inflate 未知	翻译出错，请更新
influenced 未知	翻译出错，请更新
informer 未知	翻译出错，请更新
informs 未知	翻译出错，请更新
ingenious 未知	翻译出错，请更新
ingenuity 未知	翻译出错，请更新
ingratitude 未知	翻译出错，请更新
ingredient 未知	翻译出错，请更新
inhabited 未知	翻译出错，请更新
inherit 未知	翻译出错，请更新
inimitable 未知	翻译出错，请更新
iniquity 未知	翻译出错，请更新
initials 未知	翻译出错，请更新
initiate 未知	翻译出错，请更新
initiating 未知	翻译出错，请更新
injudicious 未知	翻译出错，请更新
injuria 未知	翻译出错，请更新
injuries 未知	翻译出错，请更新
injuriously 未知	翻译出错，请更新
innkeepers 未知	翻译出错，请更新
innocence 未知	翻译出错，请更新
innocently 未知	翻译出错，请更新
innumerable 未知	翻译出错，请更新
inoperative 未知	翻译出错，请更新
inopportune 未知	翻译出错，请更新
inordinate 未知	翻译出错，请更新
inquiries 未知	翻译出错，请更新
inquiring 未知	翻译出错，请更新
inquisition 未知	翻译出错，请更新
inroads 未知	翻译出错，请更新
insect 未知	翻译出错，请更新
inserting 未知	翻译出错，请更新
insight 未知	翻译出错，请更新
insincere 未知	翻译出错，请更新
insinuated 未知	翻译出错，请更新
insinuation 未知	翻译出错，请更新
insinuations 未知	翻译出错，请更新
insolent 未知	翻译出错，请更新
inspection 未知	翻译出错，请更新
inspector 未知	翻译出错，请更新
inspiration 未知	翻译出错，请更新
inspire 未知	翻译出错，请更新
inspires 未知	翻译出错，请更新
installed 未知	翻译出错，请更新
instalment 未知	翻译出错，请更新
instalments 未知	翻译出错，请更新
instantaneously 未知	翻译出错，请更新
instinct 未知	翻译出错，请更新
instinctive 未知	翻译出错，请更新
instinctively 未知	翻译出错，请更新
instrumental 未知	翻译出错，请更新
insufficient 未知	翻译出错，请更新
insurance 未知	翻译出错，请更新
intelligence 未知	翻译出错，请更新
intelligible 未知	翻译出错，请更新
intensely 未知	翻译出错，请更新
intercalatory 未知	翻译出错，请更新
intercepted 未知	翻译出错，请更新
intercepting 未知	翻译出错，请更新
interior 未知	翻译出错，请更新
interloper 未知	翻译出错，请更新
interminable 未知	翻译出错，请更新
intermits 未知	翻译出错，请更新
intermittent 未知	翻译出错，请更新
internal 未知	翻译出错，请更新
interpolation 未知	翻译出错，请更新
interpose 未知	翻译出错，请更新
interposition 未知	翻译出错，请更新
interrogate 未知	翻译出错，请更新
interrogating 未知	翻译出错，请更新
interrupting 未知	翻译出错，请更新
intervals 未知	翻译出错，请更新
intervened 未知	翻译出错，请更新
intervention 未知	翻译出错，请更新
intimacies 未知	翻译出错，请更新
intimidation 未知	翻译出错，请更新
intolerable 未知	翻译出错，请更新
intonation 未知	翻译出错，请更新
intrigued 未知	翻译出错，请更新
introducing 未知	翻译出错，请更新
invaluable 未知	翻译出错，请更新
invective 未知	翻译出错，请更新
inveigh 未知	翻译出错，请更新
inveighed 未知	翻译出错，请更新
invention 未知	翻译出错，请更新
invest 未知	翻译出错，请更新
investigate 未知	翻译出错，请更新
investigation 未知	翻译出错，请更新
inviolable 未知	翻译出错，请更新
invites 未知	翻译出错，请更新
inviting 未知	翻译出错，请更新
involuntary 未知	翻译出错，请更新
irae 未知	翻译出错，请更新
ironclad 未知	翻译出错，请更新
ironically 未知	翻译出错，请更新
ironmonger 未知	翻译出错，请更新
irony 未知	翻译出错，请更新
irredeemably 未知	翻译出错，请更新
irregularly 未知	翻译出错，请更新
irrepressible 未知	翻译出错，请更新
irresponsible 未知	翻译出错，请更新
irretrievable 未知	翻译出错，请更新
irritated 未知	翻译出错，请更新
irritating 未知	翻译出错，请更新
isolated 未知	翻译出错，请更新
issued 未知	翻译出错，请更新
itd 未知	翻译出错，请更新
jarred 未知	翻译出错，请更新
jaunty 未知	翻译出错，请更新
jeered 未知	翻译出错，请更新
jeopardy 未知	翻译出错，请更新
jingo 未知	翻译出错，请更新
jobs 未知	翻译出错，请更新
jockey 未知	翻译出错，请更新
jocose 未知	翻译出错，请更新
jocosely 未知	翻译出错，请更新
jointure 未知	翻译出错，请更新
joked 未知	翻译出错，请更新
jokes 未知	翻译出错，请更新
jot 未知	翻译出错，请更新
jotted 未知	翻译出错，请更新
journeyings 未知	翻译出错，请更新
journeys 未知	翻译出错，请更新
jovial 未知	翻译出错，请更新
joyful 未知	翻译出错，请更新
joyfully 未知	翻译出错，请更新
judging 未知	翻译出错，请更新
judgments 未知	翻译出错，请更新
juices 未知	翻译出错，请更新
jumbled 未知	翻译出错，请更新
jumps 未知	翻译出错，请更新
juster 未知	翻译出错，请更新
justification 未知	翻译出错，请更新
justifying 未知	翻译出错，请更新
justly 未知	翻译出错，请更新
keeper 未知	翻译出错，请更新
kennedy 未知	翻译出错，请更新
kickingmatch 未知	翻译出错，请更新
kinds 未知	翻译出错，请更新
kingdoms 未知	翻译出错，请更新
kings 未知	翻译出错，请更新
kissing 未知	翻译出错，请更新
knave 未知	翻译出错，请更新
knavish 未知	翻译出错，请更新
kneebreeches 未知	翻译出错，请更新
kneeled 未知	翻译出错，请更新
kneeling 未知	翻译出错，请更新
knifegrinder 未知	翻译出错，请更新
knocking 未知	翻译出错，请更新
knowd 未知	翻译出错，请更新
knowed 未知	翻译出错，请更新
laboured 未知	翻译出错，请更新
labourer 未知	翻译出错，请更新
labourers 未知	翻译出错，请更新
lackey 未知	翻译出错，请更新
lacks 未知	翻译出错，请更新
ladylike 未知	翻译出错，请更新
lairds 未知	翻译出错，请更新
lamented 未知	翻译出错，请更新
lance 未知	翻译出错，请更新
lances 未知	翻译出错，请更新
landingplace 未知	翻译出错，请更新
landingwaiters 未知	翻译出错，请更新
landlords 未知	翻译出错，请更新
lang 未知	翻译出错，请更新
lapse 未知	翻译出错，请更新
lard 未知	翻译出错，请更新
lasting 未知	翻译出错，请更新
lastly 未知	翻译出错，请更新
lasts 未知	翻译出错，请更新
latched 未知	翻译出错，请更新
latchkey 未知	翻译出错，请更新
latitude 未知	翻译出错，请更新
laudanum 未知	翻译出错，请更新
laughingstock 未知	翻译出错，请更新
laurels 未知	翻译出错，请更新
lavish 未知	翻译出错，请更新
lawcourts 未知	翻译出错，请更新
lawmaking 未知	翻译出错，请更新
lawns 未知	翻译出错，请更新
lawyers 未知	翻译出错，请更新
lays 未知	翻译出错，请更新
lean 未知	翻译出错，请更新
leaps 未知	翻译出错，请更新
leases 未知	翻译出错，请更新
leather 未知	翻译出错，请更新
lectured 未知	翻译出错，请更新
lecturing 未知	翻译出错，请更新
ledge 未知	翻译出错，请更新
legacy 未知	翻译出错，请更新
legitimate 未知	翻译出错，请更新
legitimately 未知	翻译出错，请更新
lemonade 未知	翻译出错，请更新
lengths 未知	翻译出错，请更新
leniently 未知	翻译出错，请更新
lessened 未知	翻译出错，请更新
lesser 未知	翻译出错，请更新
lessons 未知	翻译出错，请更新
lets 未知	翻译出错，请更新
letterbox 未知	翻译出错，请更新
leviathans 未知	翻译出错，请更新
levied 未知	翻译出错，请更新
liabilities 未知	翻译出错，请更新
liar 未知	翻译出错，请更新
license 未知	翻译出错，请更新
lief 未知	翻译出错，请更新
lifeguardsman 未知	翻译出错，请更新
lifes 未知	翻译出错，请更新
lifetime 未知	翻译出错，请更新
lighted 未知	翻译出错，请更新
lightning 未知	翻译出错，请更新
likewise 未知	翻译出错，请更新
limbo 未知	翻译出错，请更新
limbs 未知	翻译出错，请更新
limit 未知	翻译出错，请更新
limited 未知	翻译出错，请更新
lined 未知	翻译出错，请更新
lining 未知	翻译出错，请更新
listener 未知	翻译出错，请更新
listeners 未知	翻译出错，请更新
listens 未知	翻译出错，请更新
livelihood 未知	翻译出错，请更新
ll 未知	翻译出错，请更新
loadstar 未知	翻译出错，请更新
loaf 未知	翻译出错，请更新
loathe 未知	翻译出错，请更新
local 未知	翻译出错，请更新
lodging 未知	翻译出错，请更新
log 未知	翻译出错，请更新
logic 未知	翻译出错，请更新
loitered 未知	翻译出错，请更新
longdrawn 未知	翻译出错，请更新
longwinded 未知	翻译出错，请更新
lookingglass 未知	翻译出错，请更新
loomed 未知	翻译出错，请更新
loose 未知	翻译出错，请更新
lordlings 未知	翻译出错，请更新
loudest 未知	翻译出错，请更新
lounging 未知	翻译出错，请更新
lout 未知	翻译出错，请更新
lovesick 未知	翻译出错，请更新
luckiest 未知	翻译出错，请更新
luggage 未知	翻译出错，请更新
lull 未知	翻译出错，请更新
luminary 未知	翻译出错，请更新
lump 未知	翻译出错，请更新
luncheonhouse 未知	翻译出错，请更新
lured 未知	翻译出错，请更新
lures 未知	翻译出错，请更新
luxury 未知	翻译出错，请更新
maam 未知	翻译出错，请更新
machinations 未知	翻译出错，请更新
madmen 未知	翻译出错，请更新
magazines 未知	翻译出错，请更新
magnanimous 未知	翻译出错，请更新
magnificentlooking 未知	翻译出错，请更新
maids 未知	翻译出错，请更新
maintenance 未知	翻译出错，请更新
mak 未知	翻译出错，请更新
makings 未知	翻译出错，请更新
maladies 未知	翻译出错，请更新
malefactors 未知	翻译出错，请更新
maligning 未知	翻译出错，请更新
malleability 未知	翻译出错，请更新
mallet 未知	翻译出错，请更新
mammas 未知	翻译出错，请更新
mane 未知	翻译出错，请更新
manikin 未知	翻译出错，请更新
manliness 未知	翻译出错，请更新
manoeuvering 未知	翻译出错，请更新
mantle 未知	翻译出错，请更新
manual 未知	翻译出错，请更新
marchioness 未知	翻译出错，请更新
margin 未知	边缘
marking 未知	翻译出错，请更新
marks 未知	翻译出错，请更新
marquis 未知	翻译出错，请更新
marred 未知	翻译出错，请更新
martyr 未知	翻译出错，请更新
marvels 未知	翻译出错，请更新
masse 未知	翻译出错，请更新
masterdom 未知	翻译出错，请更新
masterful 未知	翻译出错，请更新
masters 未知	翻译出错，请更新
matron 未知	翻译出错，请更新
matteroffact 未知	翻译出错，请更新
maudlin 未知	翻译出错，请更新
mauna 未知	翻译出错，请更新
meagre 未知	翻译出错，请更新
meals 未知	翻译出错，请更新
meaner 未知	翻译出错，请更新
measurement 未知	翻译出错，请更新
meats 未知	翻译出错，请更新
medical 未知	翻译出错，请更新
membership 未知	翻译出错，请更新
memoirs 未知	翻译出错，请更新
mending 未知	翻译出错，请更新
mentioning 未知	翻译出错，请更新
mercenary 未知	翻译出错，请更新
merchants 未知	翻译出错，请更新
merry 未知	翻译出错，请更新
messengers 未知	翻译出错，请更新
metaphorically 未知	翻译出错，请更新
method 未知	翻译出错，请更新
metropolitan 未知	翻译出错，请更新
mews 未知	翻译出错，请更新
miasma 未知	翻译出错，请更新
midwifery 未知	翻译出错，请更新
mightnt 未知	翻译出错，请更新
migrated 未知	翻译出错，请更新
migration 未知	翻译出错，请更新
milestone 未知	翻译出错，请更新
milliners 未知	翻译出错，请更新
millionaire 未知	翻译出错，请更新
mincing 未知	翻译出错，请更新
miniature 未知	翻译出错，请更新
minuet 未知	翻译出错，请更新
minutely 未知	翻译出错，请更新
miscalling 未知	翻译出错，请更新
mischance 未知	翻译出错，请更新
misgave 未知	翻译出错，请更新
misleads 未知	翻译出错，请更新
misled 未知	翻译出错，请更新
misrepresent 未知	翻译出错，请更新
mistold 未知	翻译出错，请更新
misunderstanding 未知	翻译出错，请更新
misunderstands 未知	翻译出错，请更新
mitred 未知	翻译出错，请更新
mle 未知	翻译出错，请更新
moated 未知	翻译出错，请更新
models 未知	翻译出错，请更新
modulate 未知	翻译出错，请更新
momentary 未知	翻译出错，请更新
momentum 未知	翻译出错，请更新
moneylender 未知	翻译出错，请更新
mongrel 未知	翻译出错，请更新
monogram 未知	翻译出错，请更新
monotonous 未知	翻译出错，请更新
monstrosity 未知	翻译出错，请更新
monstrous 未知	翻译出错，请更新
monument 未知	纪念碑
moods 未知	翻译出错，请更新
morbid 未知	翻译出错，请更新
morn 未知	翻译出错，请更新
morningroom 未知	翻译出错，请更新
mornings 未知	翻译出错，请更新
morsels 未知	翻译出错，请更新
mortar 未知	翻译出错，请更新
mortification 未知	翻译出错，请更新
mosquito 未知	翻译出错，请更新
moss 未知	翻译出错，请更新
motherinlaw 未知	翻译出错，请更新
moths 未知	翻译出错，请更新
mountaintop 未知	翻译出错，请更新
mouse 未知	翻译出错，请更新
mousetrap 未知	翻译出错，请更新
moustache 未知	翻译出错，请更新
mouthpiece 未知	翻译出错，请更新
mover 未知	翻译出错，请更新
muchhonoured 未知	翻译出错，请更新
muchneeded 未知	翻译出错，请更新
muddled 未知	翻译出错，请更新
muddlepated 未知	翻译出错，请更新
municipal 未知	翻译出错，请更新
murmur 未知	翻译出错，请更新
murmuring 未知	翻译出错，请更新
muscle 未知	翻译出错，请更新
musicians 未知	翻译出错，请更新
muslins 未知	翻译出错，请更新
mutilated 未知	翻译出错，请更新
mysteriously 未知	翻译出错，请更新
mystic 未知	翻译出错，请更新
myths 未知	翻译出错，请更新
nagging 未知	翻译出错，请更新
nails 未知	翻译出错，请更新
naive 未知	翻译出错，请更新
naming 未知	翻译出错，请更新
narrated 未知	翻译出错，请更新
narrative 未知	翻译出错，请更新
narrator 未知	翻译出错，请更新
naught 未知	翻译出错，请更新
neat 未知	翻译出错，请更新
neatly 未知	翻译出错，请更新
needle 未知	翻译出错，请更新
needlessly 未知	翻译出错，请更新
neednt 未知	翻译出错，请更新
neglect 未知	翻译出错，请更新
negotiating 未知	翻译出错，请更新
negotiator 未知	翻译出错，请更新
nephews 未知	翻译出错，请更新
nerves 未知	翻译出错，请更新
net 未知	翻译出错，请更新
newfangled 未知	翻译出错，请更新
nextdoor 未知	翻译出错，请更新
nicely 未知	翻译出错，请更新
niche 未知	翻译出错，请更新
nieces 未知	翻译出错，请更新
nigger 未知	翻译出错，请更新
nigher 未知	翻译出错，请更新
ninetynine 未知	翻译出错，请更新
niver 未知	翻译出错，请更新
noblemen 未知	翻译出错，请更新
nobleminded 未知	翻译出错，请更新
nobles 未知	翻译出错，请更新
nobodys 未知	翻译出错，请更新
nodding 未知	翻译出错，请更新
nods 未知	翻译出错，请更新
nominate 未知	翻译出错，请更新
nominations 未知	翻译出错，请更新
normal 未知	翻译出错，请更新
northwest 未知	翻译出错，请更新
notabilities 未知	翻译出错，请更新
notch 未知	翻译出错，请更新
noted 未知	翻译出错，请更新
notepaper 未知	翻译出错，请更新
notices 未知	翻译出错，请更新
nowadays 未知	翻译出错，请更新
numbered 未知	翻译出错，请更新
nursed 未知	翻译出错，请更新
nursing 未知	翻译出错，请更新
nutshell 未知	翻译出错，请更新
o 未知	字母 O；哦（表示惊讶等）
oaf 未知	翻译出错，请更新
oak 未知	翻译出错，请更新
oaktrees 未知	翻译出错，请更新
oar 未知	翻译出错，请更新
oars 未知	翻译出错，请更新
oath 未知	翻译出错，请更新
oaths 未知	翻译出错，请更新
oathtaking 未知	翻译出错，请更新
oats 未知	翻译出错，请更新
obdurate 未知	翻译出错，请更新
objections 未知	翻译出错，请更新
obliging 未知	翻译出错，请更新
obliterated 未知	翻译出错，请更新
observes 未知	翻译出错，请更新
obstacle 未知	翻译出错，请更新
obtrude 未知	翻译出错，请更新
obtuse 未知	翻译出错，请更新
obviously 未知	翻译出错，请更新
occasioned 未知	翻译出错，请更新
occult 未知	翻译出错，请更新
occurrence 未知	翻译出错，请更新
oddly 未知	翻译出错，请更新
odium 未知	翻译出错，请更新
odq 未知	翻译出错，请更新
officialities 未知	翻译出错，请更新
offspring 未知	翻译出错，请更新
oftenest 未知	翻译出错，请更新
oftenrepeated 未知	翻译出错，请更新
ogress 未知	翻译出错，请更新
oldaccustomed 未知	翻译出错，请更新
olden 未知	翻译出错，请更新
oldest 未知	翻译出错，请更新
oldworld 未知	翻译出错，请更新
omega 未知	翻译出错，请更新
omission 未知	翻译出错，请更新
omit 未知	翻译出错，请更新
omits 未知	翻译出错，请更新
omitting 未知	翻译出错，请更新
omnipotent 未知	翻译出错，请更新
onerous 未知	翻译出错，请更新
onslaught 未知	翻译出错，请更新
onward 未知	翻译出错，请更新
onwards 未知	翻译出错，请更新
oozing 未知	翻译出错，请更新
openlydisplayed 未知	翻译出错，请更新
openness 未知	翻译出错，请更新
opens 未知	翻译出错，请更新
operahouses 未知	翻译出错，请更新
operate 未知	翻译出错，请更新
operated 未知	翻译出错，请更新
operative 未知	翻译出错，请更新
opportune 未知	翻译出错，请更新
opposes 未知	翻译出错，请更新
opposing 未知	翻译出错，请更新
orange 未知	翻译出错，请更新
orations 未知	翻译出错，请更新
organ 未知	翻译出错，请更新
organgrinders 未知	翻译出错，请更新
originated 未知	翻译出错，请更新
originating 未知	翻译出错，请更新
ornament 未知	翻译出错，请更新
ornamental 未知	翻译出错，请更新
orphan 未知	翻译出错，请更新
ould 未知	翻译出错，请更新
ouse 未知	翻译出错，请更新
ousted 未知	翻译出错，请更新
outTurnbull 未知	翻译出错，请更新
outandout 未知	翻译出错，请更新
outbreak 未知	翻译出错，请更新
outcast 未知	翻译出错，请更新
outlay 未知	翻译出错，请更新
outline 未知	翻译出错，请更新
outlooks 未知	翻译出错，请更新
outraged 未知	翻译出错，请更新
outrageous 未知	翻译出错，请更新
outset 未知	翻译出错，请更新
outstanding 未知	翻译出错，请更新
overanxious 未知	翻译出错，请更新
overboard 未知	翻译出错，请更新
overdo 未知	翻译出错，请更新
overdominant 未知	翻译出错，请更新
overdue 未知	翻译出错，请更新
overflowing 未知	翻译出错，请更新
overgrown 未知	翻译出错，请更新
overhung 未知	翻译出错，请更新
overlooks 未知	翻译出错，请更新
overrode 未知	翻译出错，请更新
overscrupulous 未知	翻译出错，请更新
overtook 未知	翻译出错，请更新
overwhelmed 未知	翻译出错，请更新
overwhelming 未知	翻译出错，请更新
owl 未知	翻译出错，请更新
owners 未知	翻译出错，请更新
oxfences 未知	翻译出错，请更新
pacified 未知	翻译出错，请更新
packing 未知	翻译出错，请更新
padded 未知	翻译出错，请更新
paddocks 未知	翻译出错，请更新
padlock 未知	翻译出错，请更新
paean 未知	翻译出错，请更新
page 未知	翻译出错，请更新
paired 未知	翻译出错，请更新
pairing 未知	翻译出错，请更新
palace 未知	翻译出错，请更新
palatial 未知	翻译出错，请更新
palled 未知	翻译出错，请更新
palliate 未知	翻译出错，请更新
palm 未知	翻译出错，请更新
palpably 未知	翻译出错，请更新
panel 未知	翻译出错，请更新
panels 未知	翻译出错，请更新
pannier 未知	翻译出错，请更新
panting 未知	翻译出错，请更新
pantomimes 未知	翻译出错，请更新
par 未知	翻译出错，请更新
parade 未知	翻译出错，请更新
paragraph 未知	翻译出错，请更新
paragraphs 未知	翻译出错，请更新
parasol 未知	翻译出错，请更新
parentage 未知	翻译出错，请更新
parents 未知	翻译出错，请更新
parliaments 未知	翻译出错，请更新
parlourmaid 未知	翻译出错，请更新
particle 未知	翻译出错，请更新
partner 未知	翻译出错，请更新
partners 未知	翻译出错，请更新
partook 未知	翻译出错，请更新
partridges 未知	翻译出错，请更新
passengers 未知	翻译出错，请更新
pastime 未知	翻译出错，请更新
pasture 未知	翻译出错，请更新
patched 未知	翻译出错，请更新
pathetic 未知	翻译出错，请更新
pathetically 未知	翻译出错，请更新
patients 未知	翻译出错，请更新
patriarchal 未知	翻译出错，请更新
patriotic 未知	翻译出错，请更新
patted 未知	翻译出错，请更新
pattern 未知	翻译出错，请更新
paucity 未知	翻译出错，请更新
pawing 未知	翻译出错，请更新
payments 未知	翻译出错，请更新
peaceable 未知	翻译出错，请更新
peach 未知	翻译出错，请更新
peaches 未知	翻译出错，请更新
peaks 未知	翻译出错，请更新
pecuniarily 未知	翻译出错，请更新
pedigree 未知	翻译出错，请更新
peeped 未知	翻译出错，请更新
peerages 未知	翻译出错，请更新
peerless 未知	翻译出错，请更新
peg 未知	翻译出错，请更新
pelted 未知	翻译出错，请更新
penalty 未知	翻译出错，请更新
penance 未知	翻译出错，请更新
pendant 未知	翻译出错，请更新
penetrated 未知	翻译出错，请更新
penitence 未知	翻译出错，请更新
penitential 未知	翻译出错，请更新
penitently 未知	翻译出错，请更新
penned 未知	翻译出错，请更新
pensions 未知	翻译出错，请更新
peopled 未知	翻译出错，请更新
peremptorily 未知	翻译出错，请更新
performing 未知	翻译出错，请更新
perils 未知	翻译出错，请更新
periodical 未知	翻译出错，请更新
perish 未知	翻译出错，请更新
perished 未知	翻译出错，请更新
pernicious 未知	翻译出错，请更新
perpetuity 未知	翻译出错，请更新
perplexed 未知	翻译出错，请更新
persist 未知	翻译出错，请更新
persisted 未知	翻译出错，请更新
persistently 未知	翻译出错，请更新
personages 未知	翻译出错，请更新
personate 未知	翻译出错，请更新
perspicuity 未知	翻译出错，请更新
pertinacious 未知	翻译出错，请更新
pertinacity 未知	翻译出错，请更新
perusal 未知	翻译出错，请更新
perused 未知	翻译出错，请更新
perversely 未知	翻译出错，请更新
pestered 未知	翻译出错，请更新
pestilent 未知	翻译出错，请更新
pestilential 未知	翻译出错，请更新
petulantly 未知	翻译出错，请更新
phalanx 未知	翻译出错，请更新
phenomenon 未知	翻译出错，请更新
philanthropical 未知	翻译出错，请更新
philosopher 未知	翻译出错，请更新
philosophical 未知	翻译出错，请更新
philosophy 未知	翻译出错，请更新
phrase 未知	翻译出错，请更新
phrases 未知	翻译出错，请更新
physic 未知	翻译出错，请更新
physically 未知	翻译出错，请更新
physician 未知	翻译出错，请更新
physognomy 未知	翻译出错，请更新
picked 未知	翻译出错，请更新
picturebook 未知	翻译出错，请更新
picturesque 未知	翻译出错，请更新
pie 未知	翻译出错，请更新
pier 未知	翻译出错，请更新
pies 未知	翻译出错，请更新
pig 未知	翻译出错，请更新
pigeons 未知	翻译出错，请更新
pilgrimage 未知	翻译出错，请更新
pillar 未知	翻译出错，请更新
pillboxes 未知	翻译出错，请更新
pinch 未知	翻译出错，请更新
pine 未知	翻译出错，请更新
pints 未知	翻译出错，请更新
pioneer 未知	翻译出错，请更新
pitch 未知	翻译出错，请更新
piteous 未知	翻译出错，请更新
piteously 未知	翻译出错，请更新
pitied 未知	翻译出错，请更新
pits 未知	翻译出错，请更新
pitted 未知	翻译出错，请更新
pitting 未知	翻译出错，请更新
pivot 未知	翻译出错，请更新
placidly 未知	翻译出错，请更新
plainness 未知	翻译出错，请更新
plains 未知	翻译出错，请更新
plaint 未知	翻译出错，请更新
plaintive 未知	翻译出错，请更新
plaintively 未知	翻译出错，请更新
plants 未知	翻译出错，请更新
plates 未知	翻译出错，请更新
platitude 未知	翻译出错，请更新
platitudes 未知	翻译出错，请更新
platonic 未知	翻译出错，请更新
players 未知	翻译出错，请更新
playfellow 未知	翻译出错，请更新
playfellows 未知	翻译出错，请更新
playfully 未知	翻译出错，请更新
plays 未知	翻译出错，请更新
plaything 未知	翻译出错，请更新
pleading 未知	翻译出错，请更新
pleasantness 未知	翻译出错，请更新
pleasureboat 未知	翻译出错，请更新
plenary 未知	翻译出错，请更新
plighted 未知	翻译出错，请更新
plovers 未知	翻译出错，请更新
plume 未知	翻译出错，请更新
plunged 未知	翻译出错，请更新
plunging 未知	翻译出错，请更新
pm 未知	翻译出错，请更新
pocketborough 未知	翻译出错，请更新
poet 未知	翻译出错，请更新
poetic 未知	翻译出错，请更新
poked 未知	翻译出错，请更新
pole 未知	翻译出错，请更新
politicosocial 未知	翻译出错，请更新
poll 未知	翻译出错，请更新
polled 未知	翻译出错，请更新
polluted 未知	翻译出错，请更新
poltroon 未知	翻译出错，请更新
pomp 未知	翻译出错，请更新
pompous 未知	翻译出错，请更新
pondered 未知	翻译出错，请更新
poniard 未知	翻译出错，请更新
ponies 未知	翻译出错，请更新
ponys 未知	翻译出错，请更新
poorer 未知	翻译出错，请更新
poorlaw 未知	翻译出错，请更新
populace 未知	翻译出错，请更新
populous 未知	翻译出错，请更新
porch 未知	翻译出错，请更新
portrayed 未知	翻译出错，请更新
positions 未知	翻译出错，请更新
possess 未知	翻译出错，请更新
possesses 未知	翻译出错，请更新
possessor 未知	翻译出错，请更新
possibilities 未知	翻译出错，请更新
postage 未知	翻译出错，请更新
posted 未知	翻译出错，请更新
posterity 未知	翻译出错，请更新
posting 未知	翻译出错，请更新
postponement 未知	翻译出错，请更新
postponing 未知	翻译出错，请更新
posts 未知	翻译出错，请更新
pot 未知	翻译出错，请更新
potatoes 未知	翻译出错，请更新
potters 未知	翻译出错，请更新
pouch 未知	翻译出错，请更新
pouches 未知	翻译出错，请更新
pour 未知	翻译出错，请更新
pouring 未知	翻译出错，请更新
pouted 未知	翻译出错，请更新
powdered 未知	翻译出错，请更新
powerless 未知	翻译出错，请更新
practicability 未知	翻译出错，请更新
practising 未知	翻译出错，请更新
practitioner 未知	翻译出错，请更新
prairie 未知	翻译出错，请更新
praises 未知	翻译出错，请更新
prandial 未知	翻译出错，请更新
preaching 未知	翻译出错，请更新
prearrangement 未知	翻译出错，请更新
precarious 未知	翻译出错，请更新
precedent 未知	翻译出错，请更新
preceding 未知	翻译出错，请更新
precincts 未知	翻译出错，请更新
preconcerted 未知	翻译出错，请更新
precursors 未知	翻译出错，请更新
predecessor 未知	翻译出错，请更新
predominant 未知	翻译出错，请更新
preferable 未知	翻译出错，请更新
preference 未知	翻译出错，请更新
preferring 未知	翻译出错，请更新
prefix 未知	翻译出错，请更新
premature 未知	翻译出错，请更新
premises 未知	翻译出错，请更新
prentice 未知	翻译出错，请更新
prescribing 未知	翻译出错，请更新
presenting 未知	翻译出错，请更新
presently 未知	目前
presided 未知	翻译出错，请更新
presses 未知	翻译出错，请更新
pretences 未知	翻译出错，请更新
pretensions 未知	翻译出错，请更新
pretext 未知	翻译出错，请更新
prettiness 未知	翻译出错，请更新
preyed 未知	翻译出错，请更新
prick 未知	翻译出错，请更新
pricked 未知	翻译出错，请更新
priming 未知	翻译出错，请更新
primogeniture 未知	翻译出错，请更新
prince 未知	翻译出错，请更新
princess 未知	翻译出错，请更新
principles 未知	翻译出错，请更新
prison 未知	翻译出错，请更新
prisons 未知	翻译出错，请更新
privately 未知	翻译出错，请更新
prized 未知	翻译出错，请更新
prizefighting 未知	翻译出错，请更新
proceeds 未知	翻译出错，请更新
proclaim 未知	翻译出错，请更新
proclaiming 未知	翻译出错，请更新
proctors 未知	翻译出错，请更新
procure 未知	翻译出错，请更新
produces 未知	翻译出错，请更新
production 未知	翻译出错，请更新
profess 未知	翻译出错，请更新
professes 未知	翻译出错，请更新
profitable 未知	翻译出错，请更新
profitably 未知	翻译出错，请更新
profits 未知	翻译出错，请更新
progenitors 未知	翻译出错，请更新
progressed 未知	翻译出错，请更新
prohibited 未知	翻译出错，请更新
projected 未知	翻译出错，请更新
prolong 未知	翻译出错，请更新
promontory 未知	翻译出错，请更新
promoted 未知	翻译出错，请更新
promoters 未知	翻译出错，请更新
pronouncing 未知	翻译出错，请更新
prophesied 未知	翻译出错，请更新
propinquity 未知	翻译出错，请更新
proportion 未知	翻译出错，请更新
proportions 未知	翻译出错，请更新
proposes 未知	翻译出错，请更新
propounded 未知	翻译出错，请更新
propounder 未知	翻译出错，请更新
propped 未知	翻译出错，请更新
prosecute 未知	翻译出错，请更新
prosecutes 未知	翻译出错，请更新
prosecuting 未知	翻译出错，请更新
prospering 未知	翻译出错，请更新
prosperous 未知	翻译出错，请更新
prostrated 未知	翻译出错，请更新
protectors 未知	翻译出错，请更新
protestation 未知	翻译出错，请更新
protestations 未知	翻译出错，请更新
protested 未知	翻译出错，请更新
protesting 未知	翻译出错，请更新
protracted 未知	翻译出错，请更新
prouder 未知	翻译出错，请更新
proverb 未知	翻译出错，请更新
proverbial 未知	翻译出错，请更新
proves 未知	翻译出错，请更新
providing 未知	翻译出错，请更新
provincial 未知	翻译出错，请更新
provision 未知	翻译出错，请更新
provoked 未知	翻译出错，请更新
prowling 未知	翻译出错，请更新
proxy 未知	翻译出错，请更新
prunella 未知	翻译出错，请更新
pugnacity 未知	翻译出错，请更新
pulp 未知	翻译出错，请更新
pulsations 未知	翻译出错，请更新
punctilious 未知	翻译出错，请更新
punctuality 未知	翻译出错，请更新
pundit 未知	翻译出错，请更新
pupildom 未知	翻译出错，请更新
puppy 未知	翻译出错，请更新
purblind 未知	翻译出错，请更新
purchase 未知	翻译出错，请更新
purest 未知	翻译出错，请更新
purist 未知	翻译出错，请更新
purity 未知	翻译出错，请更新
purlieu 未知	翻译出错，请更新
purported 未知	翻译出错，请更新
purposed 未知	翻译出错，请更新
purred 未知	翻译出错，请更新
purse 未知	翻译出错，请更新
quail 未知	翻译出错，请更新
quailed 未知	翻译出错，请更新
quaint 未知	翻译出错，请更新
quaking 未知	翻译出错，请更新
qualification 未知	翻译出错，请更新
qualifications 未知	翻译出错，请更新
qualified 未知	翻译出错，请更新
quality 未知	翻译出错，请更新
quantity 未知	翻译出错，请更新
quarrelsome 未知	翻译出错，请更新
queens 未知	翻译出错，请更新
quelled 未知	翻译出错，请更新
quenched 未知	翻译出错，请更新
questioners 未知	翻译出错，请更新
quickness 未知	翻译出错，请更新
quieter 未知	翻译出错，请更新
quietude 未知	翻译出错，请更新
quill 未知	翻译出错，请更新
quotations 未知	翻译出错，请更新
quoting 未知	翻译出错，请更新
race 未知	翻译出错，请更新
races 未知	翻译出错，请更新
racking 未知	翻译出错，请更新
rages 未知	翻译出错，请更新
railings 未知	翻译出错，请更新
railroads 未知	翻译出错，请更新
raiment 未知	翻译出错，请更新
rain 未知	翻译出错，请更新
rainbow 未知	翻译出错，请更新
raining 未知	翻译出错，请更新
ramble 未知	翻译出错，请更新
rampant 未知	翻译出错，请更新
rancour 未知	翻译出错，请更新
rapid 未知	翻译出错，请更新
rapidity 未知	翻译出错，请更新
rapture 未知	翻译出错，请更新
raptures 未知	翻译出错，请更新
rarity 未知	翻译出错，请更新
rating 未知	翻译出错，请更新
rattling 未知	翻译出错，请更新
raving 未知	翻译出错，请更新
rawness 未知	翻译出错，请更新
realisation 未知	翻译出错，请更新
reaping 未知	翻译出错，请更新
reappear 未知	翻译出错，请更新
rearranged 未知	翻译出错，请更新
rearrangement 未知	翻译出错，请更新
rebel 未知	翻译出错，请更新
rebellion 未知	翻译出错，请更新
rebound 未知	翻译出错，请更新
recalcitrant 未知	翻译出错，请更新
recall 未知	翻译出错，请更新
recalling 未知	翻译出错，请更新
recapitulated 未知	翻译出错，请更新
receded 未知	翻译出错，请更新
receives 未知	翻译出错，请更新
receptacle 未知	翻译出错，请更新
receptions 未知	翻译出错，请更新
reclining 未知	翻译出错，请更新
recognisable 未知	翻译出错，请更新
recognize 未知	翻译出错，请更新
recommendations 未知	翻译出错，请更新
reconcile 未知	翻译出错，请更新
reconciliations 未知	翻译出错，请更新
reconciling 未知	翻译出错，请更新
recreant 未知	翻译出错，请更新
recriminate 未知	翻译出错，请更新
recruit 未知	翻译出错，请更新
recruiting 未知	翻译出错，请更新
rectified 未知	翻译出错，请更新
rectitude 未知	翻译出错，请更新
recur 未知	翻译出错，请更新
redbearded 未知	翻译出错，请更新
redfaced 未知	翻译出错，请更新
redhaired 未知	翻译出错，请更新
redheaded 未知	翻译出错，请更新
redhot 未知	翻译出错，请更新
redistribute 未知	翻译出错，请更新
redounded 未知	翻译出错，请更新
reduction 未知	翻译出错，请更新
reelected 未知	翻译出错，请更新
referring 未知	翻译出错，请更新
refined 未知	翻译出错，请更新
reflecting 未知	翻译出错，请更新
refreshing 未知	翻译出错，请更新
refusals 未知	翻译出错，请更新
refuses 未知	翻译出错，请更新
refutation 未知	翻译出错，请更新
regain 未知	翻译出错，请更新
regains 未知	翻译出错，请更新
regardless 未知	翻译出错，请更新
regeneration 未知	翻译出错，请更新
regiments 未知	翻译出错，请更新
regions 未知	翻译出错，请更新
regularity 未知	翻译出错，请更新
regulate 未知	翻译出错，请更新
rehearse 未知	翻译出错，请更新
reins 未知	翻译出错，请更新
reiterated 未知	翻译出错，请更新
rejoice 未知	翻译出错，请更新
rejoicing 未知	翻译出错，请更新
relapsed 未知	翻译出错，请更新
related 未知	翻译出错，请更新
release 未知	翻译出错，请更新
relevant 未知	翻译出错，请更新
relieve 未知	翻译出错，请更新
relinquished 未知	翻译出错，请更新
remains 未知	翻译出错，请更新
remarked 未知	翻译出错，请更新
reminded 未知	翻译出错，请更新
reminiscences 未知	翻译出错，请更新
remnant 未知	翻译出错，请更新
removal 未知	翻译出错，请更新
remove 未知	翻译出错，请更新
remunerating 未知	翻译出错，请更新
rendered 未知	翻译出错，请更新
rendings 未知	翻译出错，请更新
renegade 未知	翻译出错，请更新
renewing 未知	翻译出错，请更新
renounce 未知	翻译出错，请更新
renting 未知	翻译出错，请更新
repast 未知	翻译出错，请更新
repayment 未知	翻译出错，请更新
repeal 未知	翻译出错，请更新
repealing 未知	翻译出错，请更新
repentant 未知	翻译出错，请更新
repented 未知	翻译出错，请更新
replies 未知	翻译出错，请更新
reports 未知	翻译出错，请更新
represents 未知	翻译出错，请更新
repress 未知	翻译出错，请更新
reprimand 未知	翻译出错，请更新
reprimanding 未知	翻译出错，请更新
reproached 未知	翻译出错，请更新
reproaching 未知	翻译出错，请更新
reprobate 未知	翻译出错，请更新
reproduce 未知	翻译出错，请更新
reproducing 未知	翻译出错，请更新
repudiate 未知	翻译出错，请更新
repulsive 未知	翻译出错，请更新
requisite 未知	翻译出错，请更新
requisition 未知	翻译出错，请更新
reread 未知	翻译出错，请更新
rescuing 未知	翻译出错，请更新
resenting 未知	翻译出错，请更新
resentment 未知	翻译出错，请更新
resents 未知	翻译出错，请更新
resignations 未知	翻译出错，请更新
resistance 未知	翻译出错，请更新
resisted 未知	翻译出错，请更新
resisting 未知	翻译出错，请更新
resolutely 未知	翻译出错，请更新
resort 未知	翻译出错，请更新
resorted 未知	翻译出错，请更新
response 未知	翻译出错，请更新
resting 未知	翻译出错，请更新
restitution 未知	翻译出错，请更新
restless 未知	翻译出错，请更新
resume 未知	翻译出错，请更新
reticences 未知	翻译出错，请更新
reticent 未知	翻译出错，请更新
retirement 未知	翻译出错，请更新
retiring 未知	翻译出错，请更新
retouching 未知	翻译出错，请更新
retractation 未知	翻译出错，请更新
retrieve 未知	翻译出错，请更新
revelation 未知	翻译出错，请更新
revelations 未知	翻译出错，请更新
revenged 未知	翻译出错，请更新
reverential 未知	翻译出错，请更新
reversed 未知	翻译出错，请更新
reverted 未知	翻译出错，请更新
reviewed 未知	翻译出错，请更新
revoir 未知	翻译出错，请更新
rewards 未知	翻译出错，请更新
rheumatism 未知	翻译出错，请更新
rib 未知	翻译出错，请更新
richest 未知	翻译出错，请更新
richness 未知	翻译出错，请更新
riddles 未知	翻译出错，请更新
rife 未知	翻译出错，请更新
ringing 未知	翻译出错，请更新
rings 未知	翻译出错，请更新
rivalry 未知	翻译出错，请更新
riverbank 未知	翻译出错，请更新
rivulet 未知	翻译出错，请更新
roadsides 未知	翻译出错，请更新
roam 未知	翻译出错，请更新
roamed 未知	翻译出错，请更新
roared 未知	翻译出错，请更新
roast 未知	翻译出错，请更新
robbing 未知	翻译出错，请更新
rogues 未知	翻译出错，请更新
rolled 未知	翻译出错，请更新
romancing 未知	翻译出错，请更新
romantic 未知	翻译出错，请更新
root 未知	翻译出错，请更新
rostrum 未知	翻译出错，请更新
rottenness 未知	翻译出错，请更新
rotundus 未知	翻译出错，请更新
rou 未知	翻译出错，请更新
roundly 未知	翻译出错，请更新
roundness 未知	翻译出错，请更新
roundtopped 未知	翻译出错，请更新
rows 未知	翻译出错，请更新
rubber 未知	翻译出错，请更新
rubs 未知	翻译出错，请更新
ruddy 未知	翻译出错，请更新
rudely 未知	翻译出错，请更新
rue 未知	翻译出错，请更新
rum 未知	翻译出错，请更新
rupture 未知	翻译出错，请更新
rural 未知	翻译出错，请更新
rushes 未知	翻译出错，请更新
rusty 未知	翻译出错，请更新
sacrificing 未知	翻译出错，请更新
saddlebows 未知	翻译出错，请更新
safeguard 未知	翻译出错，请更新
safer 未知	翻译出错，请更新
sagacity 未知	翻译出错，请更新
sailed 未知	翻译出错，请更新
sailing 未知	翻译出错，请更新
sailors 未知	翻译出错，请更新
sails 未知	翻译出错，请更新
salads 未知	翻译出错，请更新
salaries 未知	翻译出错，请更新
saloon 未知	翻译出错，请更新
salt 未知	翻译出错，请更新
saltmine 未知	翻译出错，请更新
sand 未知	翻译出错，请更新
sandheaps 未知	翻译出错，请更新
sandhills 未知	翻译出错，请更新
sandwiches 未知	翻译出错，请更新
sandy 未知	翻译出错，请更新
sarcasm 未知	翻译出错，请更新
sarcasms 未知	翻译出错，请更新
satisfactory 未知	翻译出错，请更新
saunter 未知	翻译出错，请更新
saves 未知	翻译出错，请更新
saviours 未知	翻译出错，请更新
sayings 未知	翻译出错，请更新
scabbard 未知	翻译出错，请更新
scale 未知	翻译出错，请更新
scandalising 未知	翻译出错，请更新
scarce 未知	翻译出错，请更新
scaring 未知	翻译出错，请更新
scattered 未知	翻译出错，请更新
scenes 未知	翻译出错，请更新
scented 未知	翻译出错，请更新
schedule 未知	翻译出错，请更新
scheming 未知	翻译出错，请更新
scholarships 未知	翻译出错，请更新
schooled 未知	翻译出错，请更新
schooling 未知	翻译出错，请更新
science 未知	翻译出错，请更新
scissors 未知	翻译出错，请更新
scope 未知	翻译出错，请更新
scorning 未知	翻译出错，请更新
scoundrel 未知	翻译出错，请更新
scourged 未知	翻译出错，请更新
scourges 未知	翻译出错，请更新
scowled 未知	翻译出错，请更新
scowling 未知	翻译出错，请更新
scramble 未知	翻译出错，请更新
scrawled 未知	翻译出错，请更新
screams 未知	翻译出错，请更新
screening 未知	翻译出错，请更新
screw 未知	翻译出错，请更新
scrivener 未知	翻译出错，请更新
scrubby 未知	翻译出错，请更新
scrupulous 未知	翻译出错，请更新
scrupulously 未知	翻译出错，请更新
scrutinise 未知	翻译出错，请更新
scudding 未知	翻译出错，请更新
scurrilous 未知	翻译出错，请更新
scurrilously 未知	翻译出错，请更新
scurry 未知	翻译出错，请更新
scurvy 未知	翻译出错，请更新
scutcheon 未知	翻译出错，请更新
seal 未知	翻译出错，请更新
seals 未知	翻译出错，请更新
searoom 未知	翻译出错，请更新
seasick 未知	翻译出错，请更新
seasons 未知	翻译出错，请更新
seating 未知	翻译出错，请更新
seconding 未知	翻译出错，请更新
secretaries 未知	翻译出错，请更新
secretarys 未知	翻译出错，请更新
sections 未知	翻译出错，请更新
seducer 未知	翻译出错，请更新
sedulous 未知	翻译出错，请更新
seize 未知	翻译出错，请更新
seized 未知	翻译出错，请更新
seizing 未知	翻译出错，请更新
selfaction 未知	翻译出错，请更新
selfaggrandisement 未知	翻译出错，请更新
selfasserting 未知	翻译出错，请更新
selfcomplacency 未知	翻译出错，请更新
selfdenial 未知	翻译出错，请更新
selfdenying 未知	翻译出错，请更新
selfdoubt 未知	翻译出错，请更新
selfesteem 未知	翻译出错，请更新
selffloating 未知	翻译出错，请更新
selfindulgence 未知	翻译出错，请更新
selfinstituted 未知	翻译出错，请更新
selfishness 未知	翻译出错，请更新
selflaudatory 未知	翻译出错，请更新
selfpraise 未知	翻译出错，请更新
selfreliant 未知	翻译出错，请更新
selfsacrifice 未知	翻译出错，请更新
sell 未知	翻译出错，请更新
semblance 未知	翻译出错，请更新
semiFenian 未知	翻译出错，请更新
seminary 未知	翻译出错，请更新
semipurple 未知	翻译出错，请更新
senate 未知	翻译出错，请更新
senator 未知	翻译出错，请更新
sends 未知	翻译出错，请更新
sensation 未知	翻译出错，请更新
sentence 未知	翻译出错，请更新
sententious 未知	翻译出错，请更新
sentiments 未知	翻译出错，请更新
separating 未知	翻译出错，请更新
serenity 未知	翻译出错，请更新
servility 未知	翻译出错，请更新
seventh 未知	翻译出错，请更新
seventyfive 未知	翻译出错，请更新
sever 未知	翻译出错，请更新
severed 未知	翻译出错，请更新
severer 未知	翻译出错，请更新
severities 未知	翻译出错，请更新
shabby 未知	翻译出错，请更新
shaggy 未知	翻译出错，请更新
shalt 未知	翻译出错，请更新
sham 未知	翻译出错，请更新
shamed 未知	翻译出错，请更新
shameful 未知	翻译出错，请更新
shapes 未知	翻译出错，请更新
shares 未知	翻译出错，请更新
sharper 未知	翻译出错，请更新
shawl 未知	翻译出错，请更新
shawls 未知	翻译出错，请更新
shearers 未知	翻译出错，请更新
sheepish 未知	翻译出错，请更新
sheer 未知	翻译出错，请更新
sheets 未知	翻译出错，请更新
shelf 未知	翻译出错，请更新
shes 未知	翻译出错，请更新
shield 未知	翻译出错，请更新
shillings 未知	翻译出错，请更新
shillyshallying 未知	翻译出错，请更新
shindy 未知	翻译出错，请更新
shine 未知	翻译出错，请更新
shining 未知	翻译出错，请更新
shins 未知	翻译出错，请更新
shirts 未知	翻译出错，请更新
shiver 未知	翻译出错，请更新
shoals 未知	翻译出错，请更新
shock 未知	翻译出错，请更新
shocked 未知	翻译出错，请更新
shocking 未知	翻译出错，请更新
shoeblack 未知	翻译出错，请更新
shoemakers 未知	翻译出错，请更新
shooters 未知	翻译出错，请更新
shootingcoat 未知	翻译出错，请更新
shootingjacket 未知	翻译出错，请更新
shores 未知	翻译出错，请更新
shorn 未知	翻译出错，请更新
shorten 未知	翻译出错，请更新
shorter 未知	翻译出错，请更新
shortest 未知	翻译出错，请更新
shortlived 未知	翻译出错，请更新
shout 未知	翻译出错，请更新
shouted 未知	翻译出错，请更新
shovel 未知	翻译出错，请更新
shrewdly 未知	翻译出错，请更新
shrink 未知	翻译出错，请更新
shrubberies 未知	翻译出错，请更新
shrubbery 未知	翻译出错，请更新
shrubs 未知	翻译出错，请更新
shuffle 未知	翻译出错，请更新
sickness 未知	翻译出错，请更新
sidetable 未知	翻译出错，请更新
sigh 未知	翻译出错，请更新
signatures 未知	翻译出错，请更新
signifying 未知	翻译出错，请更新
silently 未知	翻译出错，请更新
silken 未知	翻译出错，请更新
silliness 未知	翻译出错，请更新
simplicity 未知	翻译出错，请更新
simultaneously 未知	翻译出错，请更新
sinecure 未知	翻译出错，请更新
singing 未知	翻译出错，请更新
singlehanded 未知	翻译出错，请更新
singlewinged 未知	翻译出错，请更新
singularity 未知	翻译出错，请更新
singularly 未知	翻译出错，请更新
sinking 未知	翻译出错，请更新
sinning 未知	翻译出错，请更新
sipped 未知	翻译出错，请更新
sipping 未知	翻译出错，请更新
sirens 未知	翻译出错，请更新
sisterly 未知	翻译出错，请更新
situated 未知	翻译出错，请更新
situation 未知	翻译出错，请更新
sixteen 未知	翻译出错，请更新
sixth 未知	翻译出错，请更新
skating 未知	翻译出错，请更新
sketch 未知	翻译出错，请更新
skipped 未知	翻译出错，请更新
slack 未知	翻译出错，请更新
slamming 未知	翻译出错，请更新
slashing 未知	翻译出错，请更新
slaughter 未知	翻译出错，请更新
slaves 未知	翻译出错，请更新
sleeping 未知	翻译出错，请更新
sleeve 未知	翻译出错，请更新
slice 未知	翻译出错，请更新
slighted 未知	翻译出错，请更新
slightingly 未知	翻译出错，请更新
slip 未知	翻译出错，请更新
slippers 未知	翻译出错，请更新
slipping 未知	翻译出错，请更新
slope 未知	翻译出错，请更新
slower 未知	翻译出错，请更新
slumber 未知	翻译出错，请更新
slung 未知	翻译出错，请更新
slur 未知	翻译出错，请更新
smaller 未知	翻译出错，请更新
smarter 未知	翻译出错，请更新
smashed 未知	翻译出错，请更新
smashing 未知	翻译出错，请更新
smite 未知	翻译出错，请更新
smoked 未知	翻译出错，请更新
smoothed 未知	翻译出错，请更新
smother 未知	翻译出错，请更新
snails 未知	翻译出错，请更新
snapped 未知	翻译出错，请更新
sneak 未知	翻译出错，请更新
snipe 未知	翻译出错，请更新
snobility 未知	翻译出错，请更新
snowy 未知	翻译出错，请更新
snubs 未知	翻译出错，请更新
sobbing 未知	翻译出错，请更新
societies 未知	翻译出错，请更新
sockets 未知	翻译出错，请更新
sodawater 未知	翻译出错，请更新
softhearted 未知	翻译出错，请更新
solicitous 未知	翻译出错，请更新
solved 未知	翻译出错，请更新
sombre 未知	翻译出错，请更新
somebodys 未知	翻译出错，请更新
sonnet 未知	翻译出错，请更新
soonest 未知	翻译出错，请更新
sorrowfully 未知	翻译出错，请更新
sorts 未知	翻译出错，请更新
soulsaving 未知	翻译出错，请更新
sounded 未知	翻译出错，请更新
soups 未知	翻译出错，请更新
sour 未知	翻译出错，请更新
spaces 未知	翻译出错，请更新
spade 未知	翻译出错，请更新
sparkle 未知	翻译出错，请更新
specimen 未知	翻译出错，请更新
speculate 未知	翻译出错，请更新
speculating 未知	翻译出错，请更新
speculative 未知	翻译出错，请更新
speechless 未知	翻译出错，请更新
speed 未知	翻译出错，请更新
sperrit 未知	翻译出错，请更新
spheres 未知	翻译出错，请更新
spinster 未知	翻译出错，请更新
spit 未知	翻译出错，请更新
splashed 未知	翻译出错，请更新
splashing 未知	翻译出错，请更新
splendid 未知	翻译出错，请更新
split 未知	翻译出错，请更新
splitting 未知	翻译出错，请更新
sponge 未知	翻译出错，请更新
spontaneously 未知	翻译出错，请更新
sportsman 未知	翻译出错，请更新
sprained 未知	翻译出错，请更新
spreading 未知	翻译出错，请更新
spretae 未知	翻译出错，请更新
sprinkling 未知	翻译出错，请更新
spurs 未知	翻译出错，请更新
sputtering 未知	翻译出错，请更新
squabble 未知	翻译出错，请更新
squad 未知	翻译出错，请更新
squarecut 未知	翻译出错，请更新
squares 未知	翻译出错，请更新
squeamish 未知	翻译出错，请更新
squeeze 未知	翻译出错，请更新
squeezed 未知	翻译出错，请更新
squire 未知	翻译出错，请更新
stabbed 未知	翻译出错，请更新
stager 未知	翻译出错，请更新
stages 未知	翻译出错，请更新
stagnation 未知	翻译出错，请更新
staked 未知	翻译出错，请更新
stalk 未知	翻译出错，请更新
stalked 未知	翻译出错，请更新
stammered 未知	翻译出错，请更新
stammering 未知	翻译出错，请更新
stamp 未知	翻译出错，请更新
stamped 未知	翻译出错，请更新
standingground 未知	翻译出错，请更新
standup 未知	翻译出错，请更新
starch 未知	翻译出错，请更新
startle 未知	翻译出错，请更新
starvation 未知	翻译出错，请更新
starve 未知	翻译出错，请更新
stateliness 未知	翻译出错，请更新
statesmanship 未知	翻译出错，请更新
stating 未知	翻译出错，请更新
stationers 未知	翻译出错，请更新
status 未知	翻译出错，请更新
stauncher 未知	翻译出错，请更新
staunchest 未知	翻译出错，请更新
stave 未知	翻译出错，请更新
stays 未知	翻译出错，请更新
steadygoing 未知	翻译出错，请更新
steamed 未知	翻译出错，请更新
steamers 未知	翻译出错，请更新
steed 未知	翻译出错，请更新
steep 未知	翻译出错，请更新
steeplechases 未知	翻译出错，请更新
steer 未知	翻译出错，请更新
stepper 未知	翻译出错，请更新
steppingstone 未知	翻译出错，请更新
sternly 未知	翻译出错，请更新
sticking 未知	翻译出错，请更新
stiffened 未知	翻译出错，请更新
stiffnecked 未知	翻译出错，请更新
stilted 未知	翻译出错，请更新
stinking 未知	翻译出错，请更新
stint 未知	翻译出错，请更新
stipulated 未知	翻译出错，请更新
stipulations 未知	翻译出错，请更新
stockings 未知	翻译出错，请更新
stomachs 未知	翻译出错，请更新
stonecutters 未知	翻译出错，请更新
stops 未知	翻译出错，请更新
straggled 未知	翻译出错，请更新
straitlaced 未知	翻译出错，请更新
stratagem 未知	翻译出错，请更新
strawberry 未知	翻译出错，请更新
straws 未知	翻译出错，请更新
streak 未知	翻译出错，请更新
strengthen 未知	翻译出错，请更新
strengthening 未知	翻译出错，请更新
stricken 未知	翻译出错，请更新
string 未知	翻译出错，请更新
stripped 未知	翻译出错，请更新
stroll 未知	翻译出错，请更新
stronghold 未知	翻译出错，请更新
stubborn 未知	翻译出错，请更新
stubbornness 未知	翻译出错，请更新
stud 未知	翻译出错，请更新
studious 未知	翻译出错，请更新
studiously 未知	翻译出错，请更新
studying 未知	翻译出错，请更新
stuff 未知	翻译出错，请更新
stuffed 未知	翻译出错，请更新
stultifying 未知	翻译出错，请更新
stumblingblock 未知	翻译出错，请更新
sturdily 未知	翻译出错，请更新
stuttering 未知	翻译出错，请更新
submission 未知	翻译出错，请更新
subscription 未知	翻译出错，请更新
subsequently 未知	翻译出错，请更新
subside 未知	翻译出错，请更新
substance 未知	翻译出错，请更新
substantial 未知	翻译出错，请更新
substantially 未知	翻译出错，请更新
substantiated 未知	翻译出错，请更新
substratum 未知	翻译出错，请更新
suburban 未知	翻译出错，请更新
succeeds 未知	翻译出错，请更新
successive 未知	翻译出错，请更新
succour 未知	翻译出错，请更新
succumbed 未知	翻译出错，请更新
suchlike 未知	翻译出错，请更新
sucked 未知	翻译出错，请更新
suckled 未知	翻译出错，请更新
suffices 未知	翻译出错，请更新
sufficiency 未知	翻译出错，请更新
suffused 未知	翻译出错，请更新
suggesting 未知	翻译出错，请更新
suggestions 未知	翻译出错，请更新
suggestive 未知	翻译出错，请更新
suicidal 未知	翻译出错，请更新
sulkily 未知	翻译出错，请更新
sulking 未知	翻译出错，请更新
sullen 未知	翻译出错，请更新
sullenness 未知	翻译出错，请更新
summon 未知	翻译出错，请更新
summoning 未知	翻译出错，请更新
sums 未知	翻译出错，请更新
sung 未知	翻译出错，请更新
sunk 未知	翻译出错，请更新
sunken 未知	翻译出错，请更新
suns 未知	翻译出错，请更新
superfluous 未知	翻译出错，请更新
superintend 未知	翻译出错，请更新
superiority 未知	翻译出错，请更新
superseded 未知	翻译出错，请更新
supper 未知	翻译出错，请更新
supplemented 未知	翻译出错，请更新
suppliant 未知	翻译出错，请更新
supplied 未知	翻译出错，请更新
supply 未知	翻译出错，请更新
supports 未知	翻译出错，请更新
supremacy 未知	翻译出错，请更新
surface 未知	翻译出错，请更新
surmises 未知	翻译出错，请更新
surrendering 未知	翻译出错，请更新
surrounded 未知	翻译出错，请更新
surveyed 未知	翻译出错，请更新
susceptibilities 未知	翻译出错，请更新
susceptible 未知	翻译出错，请更新
suspicions 未知	翻译出错，请更新
swain 未知	翻译出错，请更新
swallowing 未知	翻译出错，请更新
swallowtail 未知	翻译出错，请更新
sway 未知	翻译出错，请更新
sweets 未知	翻译出错，请更新
swelled 未知	翻译出错，请更新
swept 未知	翻译出错，请更新
swerved 未知	翻译出错，请更新
swim 未知	翻译出错，请更新
swimming 未知	翻译出错，请更新
swine 未知	翻译出错，请更新
swing 未知	翻译出错，请更新
swinging 未知	翻译出错，请更新
swords 未知	翻译出错，请更新
syllable 未知	翻译出错，请更新
symmetry 未知	翻译出错，请更新
sympathetic 未知	翻译出错，请更新
sympathetically 未知	翻译出错，请更新
sympathised 未知	翻译出错，请更新
sympathiser 未知	翻译出错，请更新
symptoms 未知	翻译出错，请更新
syne 未知	翻译出错，请更新
systematically 未知	翻译出错，请更新
ta 未知	翻译出错，请更新
tabooed 未知	翻译出错，请更新
tack 未知	翻译出错，请更新
tact 未知	翻译出错，请更新
tales 未知	翻译出错，请更新
tallowchandlers 未知	翻译出错，请更新
tame 未知	翻译出错，请更新
tamed 未知	翻译出错，请更新
taming 未知	翻译出错，请更新
targed 未知	翻译出错，请更新
target 未知	翻译出错，请更新
taunt 未知	翻译出错，请更新
taxed 未知	翻译出错，请更新
taxes 未知	翻译出错，请更新
teadrinking 未知	翻译出错，请更新
tearing 未知	翻译出错，请更新
tease 未知	翻译出错，请更新
teatime 未知	翻译出错，请更新
teen 未知	翻译出错，请更新
tellers 未知	翻译出错，请更新
telltale 未知	翻译出错，请更新
telltales 未知	翻译出错，请更新
temperament 未知	翻译出错，请更新
temples 未知	翻译出错，请更新
temporarily 未知	翻译出错，请更新
temptations 未知	翻译出错，请更新
temptress 未知	翻译出错，请更新
tenants 未知	翻译出错，请更新
tenderest 未知	翻译出错，请更新
tending 未知	翻译出错，请更新
tens 未知	翻译出错，请更新
tense 未知	翻译出错，请更新
tenure 未知	翻译出错，请更新
teres 未知	翻译出错，请更新
terrified 未知	翻译出错，请更新
terris 未知	翻译出错，请更新
territory 未知	翻译出错，请更新
tested 未知	翻译出错，请更新
thankye 未知	翻译出错，请更新
thatll 未知	翻译出错，请更新
thaw 未知	翻译出错，请更新
theft 未知	翻译出错，请更新
thereabouts 未知	翻译出错，请更新
thered 未知	翻译出错，请更新
therein 未知	翻译出错，请更新
therell 未知	翻译出错，请更新
thermometer 未知	翻译出错，请更新
theys 未知	翻译出错，请更新
thieves 未知	翻译出错，请更新
thinker 未知	翻译出错，请更新
thinness 未知	翻译出错，请更新
thirst 未知	翻译出错，请更新
thirsty 未知	翻译出错，请更新
thirteen 未知	翻译出错，请更新
thirtyfive 未知	翻译出错，请更新
thorns 未知	翻译出错，请更新
thoughtfully 未知	翻译出错，请更新
thrashing 未知	翻译出错，请更新
thread 未知	翻译出错，请更新
threats 未知	翻译出错，请更新
threecornered 未知	翻译出错，请更新
throats 未知	翻译出错，请更新
throbbing 未知	翻译出错，请更新
throne 未知	翻译出错，请更新
thrue 未知	翻译出错，请更新
thrust 未知	翻译出错，请更新
thry 未知	翻译出错，请更新
thumb 未知	翻译出错，请更新
thumbs 未知	翻译出错，请更新
thundering 未知	翻译出错，请更新
thwart 未知	翻译出错，请更新
tide 未知	翻译出错，请更新
tidewaiterships 未知	翻译出错，请更新
tight 未知	翻译出错，请更新
tightly 未知	翻译出错，请更新
timid 未知	翻译出错，请更新
tint 未知	翻译出错，请更新
tipsy 未知	翻译出错，请更新
tire 未知	翻译出错，请更新
titles 未知	翻译出错，请更新
toadies 未知	翻译出错，请更新
toast 未知	翻译出错，请更新
toasting 未知	翻译出错，请更新
tobacco 未知	翻译出错，请更新
toil 未知	翻译出错，请更新
toiled 未知	翻译出错，请更新
token 未知	翻译出错，请更新
tolerably 未知	翻译出错，请更新
tolerant 未知	翻译出错，请更新
tonights 未知	翻译出错，请更新
tools 未知	翻译出错，请更新
torment 未知	翻译出错，请更新
tormented 未知	翻译出错，请更新
torn 未知	翻译出错，请更新
tortured 未知	翻译出错，请更新
tossed 未知	翻译出错，请更新
total 未知	翻译出错，请更新
totally 未知	翻译出错，请更新
totus 未知	翻译出错，请更新
touches 未知	翻译出错，请更新
tower 未知	翻译出错，请更新
towncrier 未知	翻译出错，请更新
track 未知	翻译出错，请更新
tractable 未知	翻译出错，请更新
tradesman 未知	翻译出错，请更新
tradition 未知	翻译出错，请更新
traditional 未知	翻译出错，请更新
tragic 未知	翻译出错，请更新
trained 未知	翻译出错，请更新
traitors 未知	翻译出错，请更新
translated 未知	翻译出错，请更新
translating 未知	翻译出错，请更新
tratement 未知	翻译出错，请更新
treacherous 未知	翻译出错，请更新
treasures 未知	翻译出错，请更新
tremble 未知	翻译出错，请更新
trembled 未知	翻译出错，请更新
trembling 未知	翻译出错，请更新
tremendous 未知	翻译出错，请更新
tremens 未知	翻译出错，请更新
tremulous 未知	翻译出错，请更新
tremulously 未知	翻译出错，请更新
trepidation 未知	翻译出错，请更新
tress 未知	翻译出错，请更新
trialground 未知	翻译出错，请更新
trials 未知	翻译出错，请更新
tries 未知	翻译出错，请更新
trifles 未知	翻译出错，请更新
tripping 未知	翻译出错，请更新
trips 未知	翻译出错，请更新
trite 未知	翻译出错，请更新
triumphing 未知	翻译出错，请更新
triumphings 未知	翻译出错，请更新
trivial 未知	翻译出错，请更新
trodden 未知	翻译出错，请更新
troop 未知	翻译出错，请更新
trot 未知	翻译出错，请更新
troth 未知	翻译出错，请更新
trousers 未知	翻译出错，请更新
truce 未知	翻译出错，请更新
trumpet 未知	翻译出错，请更新
trumpets 未知	翻译出错，请更新
trusts 未知	翻译出错，请更新
tucked 未知	翻译出错，请更新
tucking 未知	翻译出错，请更新
tug 未知	翻译出错，请更新
tugging 未知	翻译出错，请更新
tuition 未知	翻译出错，请更新
tumult 未知	翻译出错，请更新
turbulent 未知	翻译出错，请更新
turkey 未知	翻译出错，请更新
turmoil 未知	翻译出错，请更新
turns 未知	翻译出错，请更新
turtle 未知	翻译出错，请更新
tutors 未知	翻译出错，请更新
twenties 未知	翻译出错，请更新
twentieth 未知	翻译出错，请更新
twentyfifth 未知	翻译出错，请更新
twentypound 未知	翻译出错，请更新
twisted 未知	翻译出错，请更新
twisting 未知	翻译出错，请更新
twit 未知	嘲弄、愚弄
twitched 未知	抽动、扭动
twopence 未知	两便士
typhus 未知	伤寒
ugliness 未知	丑陋
umbly 未知	谦卑地
unCabinet 未知	翻译出错，请更新
unEnglish 未知	翻译出错，请更新
unaccustomed 未知	不习惯的
unaffected 未知	不受影响的、自然的
unaltered 未知	未改变的
unanswered 未知	无人回应的
unassuming 未知	谦逊的
unavoidable 未知	不可避免的
unceasing 未知	不断的
uncertified 未知	未获得认证的
unchanging 未知	不变的
uncharitable 未知	不宽容的
uncomfortably 未知	不舒服地
uncommenced 未知	未开始的
uncomplimentary 未知	不赞美的
unconciliatory 未知	不调和的
unconnected 未知	无关联的
unconscious 未知	无意识的
undeceived 未知	未被欺骗的
undefined 未知	未定义的
undergo 未知	经历
undergone 未知	经历过
undersecretaryship 未知	副秘书职务
understrappers 未知	下级助手
undertaking 未知	事业、承诺
undertook 未知	承担
undeserved 未知	不应得的
undignified 未知	不庄重的
undistinguished 未知	无特别之处的
undo 未知	撤销
undoubted 未知	无疑的
undred 未知	未确认
undutiful 未知	不尽责任的
uneasiness 未知	不安
unencumbered 未知	无负担的
unendurable 未知	不可忍受的
unequal 未知	不平等的
unequalled 未知	无与伦比的
unexpectedly 未知	意外地
unfettered 未知	不受限制的
unfitness 未知	不适合
unfitting 未知	不合适的
unflinching 未知	坚定不移的
ungainly 未知	笨拙的
ungenerous 未知	小气的
ungenial 未知	不友好的
ungovernable 未知	无法控制的
ungracious 未知	不礼貌的
unhandsome 未知	不帅气的
unhappily 未知	不幸地
unimpressive 未知	无印象的
unintentionally 未知	无意地
uninteresting 未知	无趣的
uninterrupted 未知	不间断的
unison 未知	一致
united 未知	团结的
units 未知	单位
unloosed 未知	松开的
unloosing 未知	松开（进行时）
unloved 未知	不被爱的
unloving 未知	不爱人的
unluckily 未知	不幸地
unmade 未知	未制成的
unmeasured 未知	未量度的
unmindful 未知	不在意的
unmixed 未知	未混合的
unmoved 未知	未被感动的
unnatural 未知	不自然的
unnoticed 未知	未被注意的
unobserved 未知	未被观察的
unopened 未知	未打开的
unpaid 未知	未支付的
unpalatable 未知	难以接受的
unparliamentary 未知	不符合议会规定的
unpleasantsaid 未知	不愉快地说
unpoetical 未知	不具诗意的
unprecedentedly 未知	前所未有地
unprofitable 未知	无利可图的
unquestioned 未知	未被质疑的
unquiet 未知	不安静的
unravel 未知	解开
unready 未知	未准备好的
unremitting 未知	不停的
unrequited 未知	无回报的
unrivalled 未知	无与伦比的
uns 未知	未
unsavoury 未知	不愉快的
unscorched 未知	未被烧焦的
unsound 未知	不合理的
unspeaking 未知	无言的
unstable 未知	不稳定的
unstained 未知	未染色的
unsuitable 未知	不适合的
unsuited 未知	不合适的
unsympathising 未知	不表示同情的
unto 未知	到、向
untouched 未知	未触碰的
untried 未知	未经过试验的
untrustworthy 未知	不可信的
untruth 未知	不真实的
unwell 未知	不健康的
unwillingly 未知	不情愿地
unwonted 未知	不寻常的
unworthiness 未知	不配的状态
unwritten 未知	未写的
upastree 未知	在树上
upholsterer 未知	装饰工
upsetting 未知	令人不安的
upstart 未知	自命不凡的人
usage 未知	使用
usefulness 未知	有用性
uses 未知	用途
ushered 未知	引导
usurers 未知	高利贷者
utilise 未知	利用
uttermost 未知	极限的
vacation 未知	假期
vacillating 未知	犹豫不决的
vagrant 未知	流浪者
valet 未知	专车司机
valour 未知	勇气
valuables 未知	贵重物品
valueless 未知	无价值的
vanish 未知	消失
vanishing 未知	消失（进行时）
vapid 未知	乏味的
variance 未知	差异
varied 未知	多样的
varies 未知	变化
variety 未知	多样性
vary 未知	变化
varying 未知	变化（进行时）
vast 未知	广阔的
vastness 未知	浩瀚
vegetables 未知	蔬菜
vehement 未知	激烈的
vehemently 未知	激烈地
vehicle 未知	车辆
vehicles 未知	车辆（复数）
vent 未知	通风口
ventures 未知	冒险
venturing 未知	冒险（进行时）
verandah 未知	走廊
verbatim 未知	逐字地
verbiage 未知	冗长的表达
verbosity 未知	冗长
verification 未知	验证
verified 未知	已验证的
verify 未知	验证
verily 未知	确实
veritable 未知	真实的
verse 未知	诗句
veteran 未知	老兵
vexation 未知	烦恼
vexing 未知	烦恼的
via 未知	通过
vice 未知	恶习
vicinity 未知	邻近
vicious 未知	恶性的
victor 未知	胜利者
victories 未知	胜利（复数）
victorious 未知	胜利的
vindication 未知	辩护
vine 未知	藤
virgin 未知	处女
virtuous 未知	品德高尚的
viscounts 未知	子爵（复数）
vision 未知	视觉
vista 未知	远景
vitality 未知	活力
vitally 未知	至关重要地
vivacity 未知	活泼
volcanoes 未知	火山（复数）
volume 未知	体积、音量
volumes 未知	卷、体积（复数）
voluntarily 未知	自愿地
votaries 未知	信徒（复数）
voters 未知	选民（复数）
vouchsafe 未知	允诺
vows 未知	誓言（复数）
vulgar 未知	粗俗的
vulgarity 未知	粗俗
wager 未知	赌注
waived 未知	放弃
wale 未知	皱纹
wandering 未知	徘徊
wards 未知	部门
warily 未知	小心翼翼地
warmed 未知	加热的
warmest 未知	最温暖的
wars 未知	战争
wary 未知	谨慎的；小心翼翼的
waspish 未知	易怒的；尖刻的
wasting 未知	浪费的；消耗性的
watches 未知	观看；注视；手表（复数）
waterlogged 未知	浸满水的；水涝的
watermen 未知	船夫；运水人
watertight 未知	不漏水的；无懈可击的
waving 未知	挥手；挥动；波浪状的
wavy 未知	波浪形的；起伏的
weaken 未知	削弱；变弱
weakened 未知	被削弱的
weaker 未知	较弱的
weakly 未知	虚弱地；软弱地
wean 未知	使断奶；使戒除
weapon 未知	武器
weariness 未知	疲倦；困乏
wed 未知	结婚；与…… 结婚
wedding 未知	婚礼
wedged 未知	楔入的；挤进的
wedlock 未知	婚姻；已婚状态
weighted 未知	加权的；加重的
weighty 未知	重的；重大的；严肃的
wellarmed 未知	翻译出错，请更新
wellcushioned 未知	翻译出错，请更新
wellinstructed 未知	翻译出错，请更新
wells 未知	井；源泉（复数）
welltodo 未知	富裕的、富有的
welltrained 未知	训练有素的
wellworn 未知	用旧了的、破烂的
whatll 未知	翻译出错，请更新
wheel 未知	轮子；旋转
whereabouts 未知	下落；行踪
whereby 未知	凭此；借以
whimper 未知	呜咽；啜泣
whims 未知	奇想；怪念头
whined 未知	发牢骚；哭诉
whipped 未知	鞭打；搅拌（过去式）
whipperin 未知	翻译出错，请更新
whippersnapper 未知	傲慢的年轻人
whispers 未知	低语；私语（复数）
whist 未知	安静；无声
whistled 未知	吹口哨（过去式）
wholesome 未知	有益健康的；健康的
wholl 未知	谁将……
whos 未知	谁是……
wickednesses 未知	邪恶；恶行（复数）
widely 未知	广泛地
widowhood 未知	守寡；寡妇的身份
widows 未知	寡妇（复数）
wiggery 未知	假发；装饰品
wigs 未知	假发（复数）
willow 未知	柳树
winced 未知	退缩；畏缩（过去式）
windbag 未知	夸夸其谈的人
winding 未知	蜿蜒的；弯曲的
winks 未知	眨眼；使眼色（复数）
wins 未知	获胜；赢得（第三人称单数形式）
wisest 未知	最明智的
wishedfor 未知	翻译出错，请更新
withal 未知	此外；而且
withdrawal 未知	撤退；收回
withdrew 未知	撤退；收回（过去式）
withheld 未知	拒绝给予；保留（过去式）
witnesses 未知	目击；见证（复数）
wizencheeked 未知	翻译出错，请更新
wizened 未知	干瘪的；衰老的
woefully 未知	悲伤地；不幸地
womanlike 未知	女人般的
wondrously 未知	惊人地；奇妙地
wordswhen 未知	当…… 的时候的话语
workers 未知	工人（复数）
workings 未知	活动；运行；操作方法（复数）
workmen 未知	工人（复数）
wornout 未知	翻译出错，请更新
worshipping 未知	崇拜；敬奉（现在分词）
worthiest 未知	最有价值的；最值得尊敬的
wounds 未知	伤口；创伤（复数）
wrack 未知	破坏；遇难
wracked 未知	使痛苦；使遭受破坏（过去式）
wrangle 未知	争吵；争论
wrecked 未知	失事的；毁坏的
wrench 未知	扳手；猛扭
wring 未知	拧；绞
writes 未知	写；写作（第三人称单数形式）
writings 未知	作品；著作（复数）
wrongfully 未知	不公正地；错误地
wrongheaded 未知	执迷不悟的；固执错误的
wrongs 未知	错误；不公正（复数）
wroth 未知	愤怒的；狂暴的
yacht 未知	游艇
yawning 未知	打呵欠；裂开（现在分词）
yearn 未知	渴望；向往
yellowvisaged 未知	翻译出错，请更新
yeomans 未知	自耕农；自由民
yer 未知	your 的口语形式，“你的”
yesterdays 未知	昨天；往昔（复数）
yoke 未知	轭；束缚
youthful 未知	年轻的；有青春活力的
zest 未知	热情；风味。
